Aaden has 	 fav team: Cardinals 	 RedSox friends: 47 	 Cardinals friends: 18
Aaliyah has 	 fav team: Cardinals 	 RedSox friends: 30 	 Cardinals friends: 43
Aarav has 	 fav team: Red Sox 	 RedSox friends: 27 	 Cardinals friends: 55
Aaron has 	 fav team: Cardinals 	 RedSox friends: 55 	 Cardinals friends: 24
Abbie has 	 fav team: Red Sox 	 RedSox friends: 32 	 Cardinals friends: 38
Abbigail has 	 fav team: Red Sox 	 RedSox friends: 48 	 Cardinals friends: 27
Abby has 	 fav team: Cardinals 	 RedSox friends: 48 	 Cardinals friends: 27
Abdiel has 	 fav team: Red Sox 	 RedSox friends: 33 	 Cardinals friends: 47
Abdullah has 	 fav team: Red Sox 	 RedSox friends: 52 	 Cardinals friends: 20
Abel has 	 fav team: Cardinals 	 RedSox friends: 51 	 Cardinals friends: 23
Abigail has 	 fav team: Red Sox 	 RedSox friends: 33 	 Cardinals friends: 49
Abraham has 	 fav team: Red Sox 	 RedSox friends: 48 	 Cardinals friends: 22
Abram has 	 fav team: Red Sox 	 RedSox friends: 54 	 Cardinals friends: 33
Abrielle has 	 fav team: Red Sox 	 RedSox friends: 72 	 Cardinals friends: 30
Abril has 	 fav team: Cardinals 	 RedSox friends: 25 	 Cardinals friends: 37
Ace has 	 fav team: Cardinals 	 RedSox friends: 21 	 Cardinals friends: 40
Ada has 	 fav team: Cardinals 	 RedSox friends: 38 	 Cardinals friends: 28
Adalyn has 	 fav team: Cardinals 	 RedSox friends: 33 	 Cardinals friends: 55
Adalynn has 	 fav team: Red Sox 	 RedSox friends: 58 	 Cardinals friends: 33
Adam has 	 fav team: Red Sox 	 RedSox friends: 52 	 Cardinals friends: 29
Adan has 	 fav team: Red Sox 	 RedSox friends: 49 	 Cardinals friends: 28
Addilyn has 	 fav team: Red Sox 	 RedSox friends: 51 	 Cardinals friends: 30
Addison has 	 fav team: Red Sox 	 RedSox friends: 41 	 Cardinals friends: 36
Addisyn has 	 fav team: Cardinals 	 RedSox friends: 36 	 Cardinals friends: 43
Addyson has 	 fav team: Cardinals 	 RedSox friends: 37 	 Cardinals friends: 44
Adelaide has 	 fav team: Cardinals 	 RedSox friends: 34 	 Cardinals friends: 45
Adele has 	 fav team: Cardinals 	 RedSox friends: 35 	 Cardinals friends: 45
Adelina has 	 fav team: Cardinals 	 RedSox friends: 26 	 Cardinals friends: 50
Adeline has 	 fav team: Cardinals 	 RedSox friends: 62 	 Cardinals friends: 27
Adelyn has 	 fav team: Cardinals 	 RedSox friends: 30 	 Cardinals friends: 46
Adelynn has 	 fav team: Red Sox 	 RedSox friends: 52 	 Cardinals friends: 27
Aden has 	 fav team: Red Sox 	 RedSox friends: 47 	 Cardinals friends: 34
Aditya has 	 fav team: Red Sox 	 RedSox friends: 50 	 Cardinals friends: 28
Adley has 	 fav team: Cardinals 	 RedSox friends: 29 	 Cardinals friends: 49
Adonis has 	 fav team: Cardinals 	 RedSox friends: 35 	 Cardinals friends: 41
Adrian has 	 fav team: Cardinals 	 RedSox friends: 46 	 Cardinals friends: 34
Adriana has 	 fav team: Cardinals 	 RedSox friends: 32 	 Cardinals friends: 51
Adrianna has 	 fav team: Red Sox 	 RedSox friends: 46 	 Cardinals friends: 21
Adriel has 	 fav team: Cardinals 	 RedSox friends: 57 	 Cardinals friends: 31
Adrien has 	 fav team: Cardinals 	 RedSox friends: 20 	 Cardinals friends: 46
Adrienne has 	 fav team: Cardinals 	 RedSox friends: 21 	 Cardinals friends: 39
Agustin has 	 fav team: Cardinals 	 RedSox friends: 27 	 Cardinals friends: 50
Ahmad has 	 fav team: Cardinals 	 RedSox friends: 47 	 Cardinals friends: 48
Ahmed has 	 fav team: Red Sox 	 RedSox friends: 42 	 Cardinals friends: 23
Aidan has 	 fav team: Cardinals 	 RedSox friends: 33 	 Cardinals friends: 50
Aiden has 	 fav team: Cardinals 	 RedSox friends: 29 	 Cardinals friends: 47
Aidyn has 	 fav team: Cardinals 	 RedSox friends: 23 	 Cardinals friends: 50
Aileen has 	 fav team: Red Sox 	 RedSox friends: 42 	 Cardinals friends: 28
Aimee has 	 fav team: Cardinals 	 RedSox friends: 25 	 Cardinals friends: 51
Ainsley has 	 fav team: Cardinals 	 RedSox friends: 26 	 Cardinals friends: 46
Aisha has 	 fav team: Cardinals 	 RedSox friends: 27 	 Cardinals friends: 46
Aiyana has 	 fav team: Cardinals 	 RedSox friends: 30 	 Cardinals friends: 43
Akira has 	 fav team: Red Sox 	 RedSox friends: 48 	 Cardinals friends: 32
Alaina has 	 fav team: Red Sox 	 RedSox friends: 44 	 Cardinals friends: 26
Alan has 	 fav team: Cardinals 	 RedSox friends: 30 	 Cardinals friends: 53
Alana has 	 fav team: Cardinals 	 RedSox friends: 33 	 Cardinals friends: 56
Alani has 	 fav team: Cardinals 	 RedSox friends: 22 	 Cardinals friends: 50
Alanna has 	 fav team: Cardinals 	 RedSox friends: 29 	 Cardinals friends: 46
Alannah has 	 fav team: Red Sox 	 RedSox friends: 33 	 Cardinals friends: 39
Alaya has 	 fav team: Red Sox 	 RedSox friends: 44 	 Cardinals friends: 34
Alayah has 	 fav team: Cardinals 	 RedSox friends: 23 	 Cardinals friends: 42
Alayna has 	 fav team: Cardinals 	 RedSox friends: 40 	 Cardinals friends: 50
Alaysia has 	 fav team: Cardinals 	 RedSox friends: 28 	 Cardinals friends: 44
Albert has 	 fav team: Cardinals 	 RedSox friends: 25 	 Cardinals friends: 39
Alberto has 	 fav team: Cardinals 	 RedSox friends: 23 	 Cardinals friends: 47
Alden has 	 fav team: Cardinals 	 RedSox friends: 32 	 Cardinals friends: 50
Aldo has 	 fav team: Red Sox 	 RedSox friends: 48 	 Cardinals friends: 30
Aleah has 	 fav team: Red Sox 	 RedSox friends: 45 	 Cardinals friends: 33
Alec has 	 fav team: Cardinals 	 RedSox friends: 33 	 Cardinals friends: 55
Aleena has 	 fav team: Cardinals 	 RedSox friends: 24 	 Cardinals friends: 49
Aleigha has 	 fav team: Cardinals 	 RedSox friends: 24 	 Cardinals friends: 47
Alejandra has 	 fav team: Red Sox 	 RedSox friends: 51 	 Cardinals friends: 34
Alejandro has 	 fav team: Red Sox 	 RedSox friends: 45 	 Cardinals friends: 24
Alena has 	 fav team: Cardinals 	 RedSox friends: 34 	 Cardinals friends: 58
Alessandra has 	 fav team: Red Sox 	 RedSox friends: 47 	 Cardinals friends: 32
Alessandro has 	 fav team: Red Sox 	 RedSox friends: 48 	 Cardinals friends: 24
Alex has 	 fav team: Cardinals 	 RedSox friends: 32 	 Cardinals friends: 51
Alexa has 	 fav team: Red Sox 	 RedSox friends: 53 	 Cardinals friends: 24
Alexander has 	 fav team: Cardinals 	 RedSox friends: 32 	 Cardinals friends: 44
Alexandra has 	 fav team: Red Sox 	 RedSox friends: 49 	 Cardinals friends: 26
Alexandria has 	 fav team: Red Sox 	 RedSox friends: 45 	 Cardinals friends: 32
Alexia has 	 fav team: Cardinals 	 RedSox friends: 38 	 Cardinals friends: 55
Alexis has 	 fav team: Cardinals 	 RedSox friends: 33 	 Cardinals friends: 50
Alexzander has 	 fav team: Red Sox 	 RedSox friends: 57 	 Cardinals friends: 32
Alfonso has 	 fav team: Cardinals 	 RedSox friends: 34 	 Cardinals friends: 47
Alfred has 	 fav team: Cardinals 	 RedSox friends: 30 	 Cardinals friends: 66
Alfredo has 	 fav team: Cardinals 	 RedSox friends: 25 	 Cardinals friends: 49
Ali has 	 fav team: Cardinals 	 RedSox friends: 28 	 Cardinals friends: 55
Alia has 	 fav team: Cardinals 	 RedSox friends: 33 	 Cardinals friends: 41
Aliana has 	 fav team: Cardinals 	 RedSox friends: 29 	 Cardinals friends: 54
Alice has 	 fav team: Red Sox 	 RedSox friends: 52 	 Cardinals friends: 13
Alicia has 	 fav team: Red Sox 	 RedSox friends: 40 	 Cardinals friends: 31
Alijah has 	 fav team: Cardinals 	 RedSox friends: 30 	 Cardinals friends: 53
Alina has 	 fav team: Cardinals 	 RedSox friends: 25 	 Cardinals friends: 37
Alisa has 	 fav team: Cardinals 	 RedSox friends: 35 	 Cardinals friends: 49
Alisha has 	 fav team: Red Sox 	 RedSox friends: 46 	 Cardinals friends: 17
Alison has 	 fav team: Red Sox 	 RedSox friends: 45 	 Cardinals friends: 22
Alissa has 	 fav team: Cardinals 	 RedSox friends: 34 	 Cardinals friends: 59
Alisson has 	 fav team: Cardinals 	 RedSox friends: 30 	 Cardinals friends: 51
Alivia has 	 fav team: Cardinals 	 RedSox friends: 27 	 Cardinals friends: 45
Aliya has 	 fav team: Red Sox 	 RedSox friends: 43 	 Cardinals friends: 32
Aliyah has 	 fav team: Red Sox 	 RedSox friends: 45 	 Cardinals friends: 27
Aliza has 	 fav team: Red Sox 	 RedSox friends: 47 	 Cardinals friends: 25
Allan has 	 fav team: Red Sox 	 RedSox friends: 43 	 Cardinals friends: 30
Allen has 	 fav team: Red Sox 	 RedSox friends: 51 	 Cardinals friends: 31
Allie has 	 fav team: Red Sox 	 RedSox friends: 49 	 Cardinals friends: 30
Allison has 	 fav team: Cardinals 	 RedSox friends: 29 	 Cardinals friends: 51
Ally has 	 fav team: Cardinals 	 RedSox friends: 29 	 Cardinals friends: 50
Allyson has 	 fav team: Cardinals 	 RedSox friends: 30 	 Cardinals friends: 38
Alma has 	 fav team: Red Sox 	 RedSox friends: 57 	 Cardinals friends: 32
Alondra has 	 fav team: Red Sox 	 RedSox friends: 39 	 Cardinals friends: 27
Alonso has 	 fav team: Red Sox 	 RedSox friends: 38 	 Cardinals friends: 29
Alonzo has 	 fav team: Cardinals 	 RedSox friends: 31 	 Cardinals friends: 48
Alvaro has 	 fav team: Red Sox 	 RedSox friends: 54 	 Cardinals friends: 19
Alvin has 	 fav team: Cardinals 	 RedSox friends: 23 	 Cardinals friends: 52
Alyson has 	 fav team: Cardinals 	 RedSox friends: 28 	 Cardinals friends: 50
Alyssa has 	 fav team: Cardinals 	 RedSox friends: 37 	 Cardinals friends: 51
Alyvia has 	 fav team: Cardinals 	 RedSox friends: 29 	 Cardinals friends: 51
Amanda has 	 fav team: Red Sox 	 RedSox friends: 40 	 Cardinals friends: 30
Amani has 	 fav team: Red Sox 	 RedSox friends: 44 	 Cardinals friends: 34
Amara has 	 fav team: Cardinals 	 RedSox friends: 24 	 Cardinals friends: 57
Amare has 	 fav team: Cardinals 	 RedSox friends: 33 	 Cardinals friends: 42
Amari has 	 fav team: Cardinals 	 RedSox friends: 33 	 Cardinals friends: 53
Amaya has 	 fav team: Cardinals 	 RedSox friends: 35 	 Cardinals friends: 40
Amber has 	 fav team: Red Sox 	 RedSox friends: 48 	 Cardinals friends: 30
Ameer has 	 fav team: Cardinals 	 RedSox friends: 39 	 Cardinals friends: 54
Amelia has 	 fav team: Cardinals 	 RedSox friends: 27 	 Cardinals friends: 51
Amelie has 	 fav team: Cardinals 	 RedSox friends: 24 	 Cardinals friends: 54
America has 	 fav team: Cardinals 	 RedSox friends: 28 	 Cardinals friends: 39
Amina has 	 fav team: Cardinals 	 RedSox friends: 20 	 Cardinals friends: 41
Amir has 	 fav team: Cardinals 	 RedSox friends: 24 	 Cardinals friends: 50
Amira has 	 fav team: Red Sox 	 RedSox friends: 49 	 Cardinals friends: 25
Amirah has 	 fav team: Cardinals 	 RedSox friends: 23 	 Cardinals friends: 47
Amiya has 	 fav team: Red Sox 	 RedSox friends: 60 	 Cardinals friends: 36
Amiyah has 	 fav team: Red Sox 	 RedSox friends: 42 	 Cardinals friends: 31
Amos has 	 fav team: Red Sox 	 RedSox friends: 49 	 Cardinals friends: 28
Amy has 	 fav team: Red Sox 	 RedSox friends: 52 	 Cardinals friends: 28
Amya has 	 fav team: Cardinals 	 RedSox friends: 36 	 Cardinals friends: 44
Ana has 	 fav team: Cardinals 	 RedSox friends: 28 	 Cardinals friends: 46
Anabel has 	 fav team: Red Sox 	 RedSox friends: 37 	 Cardinals friends: 29
Anabella has 	 fav team: Red Sox 	 RedSox friends: 50 	 Cardinals friends: 29
Anabelle has 	 fav team: Red Sox 	 RedSox friends: 53 	 Cardinals friends: 28
Anahi has 	 fav team: Red Sox 	 RedSox friends: 59 	 Cardinals friends: 30
Analia has 	 fav team: Cardinals 	 RedSox friends: 26 	 Cardinals friends: 43
Anastasia has 	 fav team: Cardinals 	 RedSox friends: 28 	 Cardinals friends: 40
Anaya has 	 fav team: Red Sox 	 RedSox friends: 43 	 Cardinals friends: 36
Anders has 	 fav team: Red Sox 	 RedSox friends: 39 	 Cardinals friends: 25
Anderson has 	 fav team: Red Sox 	 RedSox friends: 48 	 Cardinals friends: 35
Andre has 	 fav team: Red Sox 	 RedSox friends: 52 	 Cardinals friends: 37
Andrea has 	 fav team: Cardinals 	 RedSox friends: 39 	 Cardinals friends: 50
Andres has 	 fav team: Cardinals 	 RedSox friends: 25 	 Cardinals friends: 49
Andrew has 	 fav team: Cardinals 	 RedSox friends: 20 	 Cardinals friends: 40
Andy has 	 fav team: Red Sox 	 RedSox friends: 57 	 Cardinals friends: 20
Angel has 	 fav team: Red Sox 	 RedSox friends: 48 	 Cardinals friends: 37
Angela has 	 fav team: Red Sox 	 RedSox friends: 43 	 Cardinals friends: 21
Angelica has 	 fav team: Red Sox 	 RedSox friends: 42 	 Cardinals friends: 30
Angelina has 	 fav team: Red Sox 	 RedSox friends: 37 	 Cardinals friends: 33
Angeline has 	 fav team: Red Sox 	 RedSox friends: 49 	 Cardinals friends: 29
Angelique has 	 fav team: Red Sox 	 RedSox friends: 59 	 Cardinals friends: 28
Angelo has 	 fav team: Red Sox 	 RedSox friends: 44 	 Cardinals friends: 40
Angie has 	 fav team: Cardinals 	 RedSox friends: 29 	 Cardinals friends: 47
Anika has 	 fav team: Cardinals 	 RedSox friends: 31 	 Cardinals friends: 43
Aniya has 	 fav team: Cardinals 	 RedSox friends: 23 	 Cardinals friends: 49
Aniyah has 	 fav team: Red Sox 	 RedSox friends: 37 	 Cardinals friends: 25
Ann has 	 fav team: Red Sox 	 RedSox friends: 57 	 Cardinals friends: 26
Anna has 	 fav team: Cardinals 	 RedSox friends: 37 	 Cardinals friends: 34
Annabel has 	 fav team: Cardinals 	 RedSox friends: 30 	 Cardinals friends: 43
Annabell has 	 fav team: Cardinals 	 RedSox friends: 28 	 Cardinals friends: 37
Annabella has 	 fav team: Red Sox 	 RedSox friends: 50 	 Cardinals friends: 26
Annabelle has 	 fav team: Red Sox 	 RedSox friends: 58 	 Cardinals friends: 26
Annalee has 	 fav team: Cardinals 	 RedSox friends: 36 	 Cardinals friends: 61
Annalise has 	 fav team: Cardinals 	 RedSox friends: 34 	 Cardinals friends: 46
Anne has 	 fav team: Cardinals 	 RedSox friends: 38 	 Cardinals friends: 43
Annie has 	 fav team: Red Sox 	 RedSox friends: 48 	 Cardinals friends: 35
Annika has 	 fav team: Cardinals 	 RedSox friends: 32 	 Cardinals friends: 49
Ansley has 	 fav team: Red Sox 	 RedSox friends: 55 	 Cardinals friends: 28
Anthony has 	 fav team: Cardinals 	 RedSox friends: 30 	 Cardinals friends: 47
Antoine has 	 fav team: Cardinals 	 RedSox friends: 39 	 Cardinals friends: 46
Anton has 	 fav team: Cardinals 	 RedSox friends: 31 	 Cardinals friends: 43
Antonio has 	 fav team: Cardinals 	 RedSox friends: 36 	 Cardinals friends: 44
Anya has 	 fav team: Cardinals 	 RedSox friends: 26 	 Cardinals friends: 43
Apollo has 	 fav team: Cardinals 	 RedSox friends: 26 	 Cardinals friends: 41
April has 	 fav team: Red Sox 	 RedSox friends: 37 	 Cardinals friends: 30
Arabella has 	 fav team: Cardinals 	 RedSox friends: 36 	 Cardinals friends: 43
Araceli has 	 fav team: Cardinals 	 RedSox friends: 33 	 Cardinals friends: 53
Archer has 	 fav team: Red Sox 	 RedSox friends: 46 	 Cardinals friends: 26
Arely has 	 fav team: Cardinals 	 RedSox friends: 20 	 Cardinals friends: 48
Ari has 	 fav team: Red Sox 	 RedSox friends: 52 	 Cardinals friends: 29
Aria has 	 fav team: Red Sox 	 RedSox friends: 45 	 Cardinals friends: 28
Ariah has 	 fav team: Cardinals 	 RedSox friends: 31 	 Cardinals friends: 53
Arian has 	 fav team: Cardinals 	 RedSox friends: 37 	 Cardinals friends: 46
Ariana has 	 fav team: Cardinals 	 RedSox friends: 27 	 Cardinals friends: 48
Arianna has 	 fav team: Cardinals 	 RedSox friends: 32 	 Cardinals friends: 57
Ariel has 	 fav team: Red Sox 	 RedSox friends: 41 	 Cardinals friends: 24
Ariella has 	 fav team: Red Sox 	 RedSox friends: 46 	 Cardinals friends: 33
Arielle has 	 fav team: Red Sox 	 RedSox friends: 56 	 Cardinals friends: 25
Arjun has 	 fav team: Red Sox 	 RedSox friends: 53 	 Cardinals friends: 25
Arlo has 	 fav team: Cardinals 	 RedSox friends: 43 	 Cardinals friends: 31
Armando has 	 fav team: Cardinals 	 RedSox friends: 30 	 Cardinals friends: 52
Armani has 	 fav team: Cardinals 	 RedSox friends: 33 	 Cardinals friends: 49
Arnav has 	 fav team: Cardinals 	 RedSox friends: 34 	 Cardinals friends: 52
Aron has 	 fav team: Red Sox 	 RedSox friends: 47 	 Cardinals friends: 20
Arthur has 	 fav team: Red Sox 	 RedSox friends: 36 	 Cardinals friends: 36
Arturo has 	 fav team: Red Sox 	 RedSox friends: 46 	 Cardinals friends: 41
Arya has 	 fav team: Cardinals 	 RedSox friends: 30 	 Cardinals friends: 51
Aryan has 	 fav team: Cardinals 	 RedSox friends: 26 	 Cardinals friends: 50
Aryana has 	 fav team: Cardinals 	 RedSox friends: 37 	 Cardinals friends: 46
Aryanna has 	 fav team: Red Sox 	 RedSox friends: 44 	 Cardinals friends: 28
Asa has 	 fav team: Cardinals 	 RedSox friends: 23 	 Cardinals friends: 33
Asher has 	 fav team: Cardinals 	 RedSox friends: 33 	 Cardinals friends: 42
Ashley has 	 fav team: Red Sox 	 RedSox friends: 62 	 Cardinals friends: 30
Ashlyn has 	 fav team: Red Sox 	 RedSox friends: 43 	 Cardinals friends: 33
Ashlynn has 	 fav team: Red Sox 	 RedSox friends: 53 	 Cardinals friends: 34
Ashton has 	 fav team: Red Sox 	 RedSox friends: 51 	 Cardinals friends: 25
Ashtyn has 	 fav team: Red Sox 	 RedSox friends: 48 	 Cardinals friends: 33
Asia has 	 fav team: Red Sox 	 RedSox friends: 33 	 Cardinals friends: 18
Aspen has 	 fav team: Cardinals 	 RedSox friends: 28 	 Cardinals friends: 46
Athena has 	 fav team: Red Sox 	 RedSox friends: 46 	 Cardinals friends: 29
Atticus has 	 fav team: Red Sox 	 RedSox friends: 47 	 Cardinals friends: 29
Aubree has 	 fav team: Cardinals 	 RedSox friends: 29 	 Cardinals friends: 52
Aubrey has 	 fav team: Cardinals 	 RedSox friends: 20 	 Cardinals friends: 58
Aubri has 	 fav team: Cardinals 	 RedSox friends: 22 	 Cardinals friends: 42
Aubriana has 	 fav team: Red Sox 	 RedSox friends: 52 	 Cardinals friends: 29
Aubrianna has 	 fav team: Red Sox 	 RedSox friends: 48 	 Cardinals friends: 35
Aubrie has 	 fav team: Cardinals 	 RedSox friends: 37 	 Cardinals friends: 44
Aubrielle has 	 fav team: Red Sox 	 RedSox friends: 45 	 Cardinals friends: 35
Audrey has 	 fav team: Red Sox 	 RedSox friends: 45 	 Cardinals friends: 24
Audriana has 	 fav team: Red Sox 	 RedSox friends: 49 	 Cardinals friends: 28
Audrianna has 	 fav team: Red Sox 	 RedSox friends: 53 	 Cardinals friends: 33
Audrina has 	 fav team: Red Sox 	 RedSox friends: 37 	 Cardinals friends: 29
August has 	 fav team: Cardinals 	 RedSox friends: 35 	 Cardinals friends: 53
Augustine has 	 fav team: Cardinals 	 RedSox friends: 31 	 Cardinals friends: 53
Augustus has 	 fav team: Cardinals 	 RedSox friends: 41 	 Cardinals friends: 50
Aurora has 	 fav team: Cardinals 	 RedSox friends: 28 	 Cardinals friends: 50
Austin has 	 fav team: Red Sox 	 RedSox friends: 63 	 Cardinals friends: 24
Austyn has 	 fav team: Red Sox 	 RedSox friends: 40 	 Cardinals friends: 23
Autumn has 	 fav team: Red Sox 	 RedSox friends: 47 	 Cardinals friends: 27
Ava has 	 fav team: Red Sox 	 RedSox friends: 56 	 Cardinals friends: 25
Avah has 	 fav team: Red Sox 	 RedSox friends: 56 	 Cardinals friends: 38
Averi has 	 fav team: Cardinals 	 RedSox friends: 42 	 Cardinals friends: 42
Averie has 	 fav team: Cardinals 	 RedSox friends: 32 	 Cardinals friends: 36
Avery has 	 fav team: Cardinals 	 RedSox friends: 31 	 Cardinals friends: 47
Aviana has 	 fav team: Cardinals 	 RedSox friends: 31 	 Cardinals friends: 51
Avianna has 	 fav team: Red Sox 	 RedSox friends: 33 	 Cardinals friends: 34
Axel has 	 fav team: Cardinals 	 RedSox friends: 20 	 Cardinals friends: 52
Axton has 	 fav team: Cardinals 	 RedSox friends: 28 	 Cardinals friends: 39
Aya has 	 fav team: Cardinals 	 RedSox friends: 35 	 Cardinals friends: 52
Ayaan has 	 fav team: Cardinals 	 RedSox friends: 28 	 Cardinals friends: 39
Ayana has 	 fav team: Red Sox 	 RedSox friends: 58 	 Cardinals friends: 31
Ayanna has 	 fav team: Red Sox 	 RedSox friends: 53 	 Cardinals friends: 30
Aydan has 	 fav team: Cardinals 	 RedSox friends: 22 	 Cardinals friends: 47
Ayden has 	 fav team: Cardinals 	 RedSox friends: 28 	 Cardinals friends: 42
Aydin has 	 fav team: Cardinals 	 RedSox friends: 19 	 Cardinals friends: 65
Ayla has 	 fav team: Red Sox 	 RedSox friends: 45 	 Cardinals friends: 34
Ayleen has 	 fav team: Red Sox 	 RedSox friends: 61 	 Cardinals friends: 30
Aylin has 	 fav team: Cardinals 	 RedSox friends: 26 	 Cardinals friends: 57
Azalea has 	 fav team: Red Sox 	 RedSox friends: 37 	 Cardinals friends: 32
Azaria has 	 fav team: Cardinals 	 RedSox friends: 25 	 Cardinals friends: 47
Azariah has 	 fav team: Red Sox 	 RedSox friends: 47 	 Cardinals friends: 27
Bailee has 	 fav team: Cardinals 	 RedSox friends: 30 	 Cardinals friends: 40
Bailey has 	 fav team: Red Sox 	 RedSox friends: 42 	 Cardinals friends: 21
Barbara has 	 fav team: Cardinals 	 RedSox friends: 35 	 Cardinals friends: 52
Barrett has 	 fav team: Red Sox 	 RedSox friends: 39 	 Cardinals friends: 31
Baylee has 	 fav team: Cardinals 	 RedSox friends: 25 	 Cardinals friends: 39
Bayleigh has 	 fav team: Red Sox 	 RedSox friends: 57 	 Cardinals friends: 27
Beatrice has 	 fav team: Cardinals 	 RedSox friends: 24 	 Cardinals friends: 52
Beau has 	 fav team: Cardinals 	 RedSox friends: 23 	 Cardinals friends: 55
Beckett has 	 fav team: Cardinals 	 RedSox friends: 26 	 Cardinals friends: 51
Beckham has 	 fav team: Cardinals 	 RedSox friends: 40 	 Cardinals friends: 45
Belen has 	 fav team: Cardinals 	 RedSox friends: 30 	 Cardinals friends: 59
Bella has 	 fav team: Red Sox 	 RedSox friends: 43 	 Cardinals friends: 23
Ben has 	 fav team: Cardinals 	 RedSox friends: 34 	 Cardinals friends: 42
Benjamin has 	 fav team: Cardinals 	 RedSox friends: 28 	 Cardinals friends: 36
Bennett has 	 fav team: Red Sox 	 RedSox friends: 46 	 Cardinals friends: 24
Benson has 	 fav team: Red Sox 	 RedSox friends: 56 	 Cardinals friends: 23
Bentlee has 	 fav team: Red Sox 	 RedSox friends: 56 	 Cardinals friends: 29
Bentley has 	 fav team: Cardinals 	 RedSox friends: 24 	 Cardinals friends: 54
Bently has 	 fav team: Cardinals 	 RedSox friends: 25 	 Cardinals friends: 54
Benton has 	 fav team: Red Sox 	 RedSox friends: 50 	 Cardinals friends: 21
Bethany has 	 fav team: Cardinals 	 RedSox friends: 23 	 Cardinals friends: 45
Bianca has 	 fav team: Cardinals 	 RedSox friends: 31 	 Cardinals friends: 50
Billy has 	 fav team: Cardinals 	 RedSox friends: 29 	 Cardinals friends: 50
Blaine has 	 fav team: Red Sox 	 RedSox friends: 45 	 Cardinals friends: 23
Blair has 	 fav team: Red Sox 	 RedSox friends: 46 	 Cardinals friends: 34
Blaise has 	 fav team: Red Sox 	 RedSox friends: 53 	 Cardinals friends: 24
Blake has 	 fav team: Cardinals 	 RedSox friends: 28 	 Cardinals friends: 39
Blakely has 	 fav team: Cardinals 	 RedSox friends: 34 	 Cardinals friends: 56
Blaze has 	 fav team: Red Sox 	 RedSox friends: 55 	 Cardinals friends: 38
Bo has 	 fav team: Red Sox 	 RedSox friends: 54 	 Cardinals friends: 21
Bobby has 	 fav team: Cardinals 	 RedSox friends: 28 	 Cardinals friends: 39
Bodhi has 	 fav team: Cardinals 	 RedSox friends: 35 	 Cardinals friends: 48
Boston has 	 fav team: Red Sox 	 RedSox friends: 51 	 Cardinals friends: 22
Bowen has 	 fav team: Cardinals 	 RedSox friends: 21 	 Cardinals friends: 53
Braden has 	 fav team: Cardinals 	 RedSox friends: 35 	 Cardinals friends: 55
Bradley has 	 fav team: Red Sox 	 RedSox friends: 59 	 Cardinals friends: 30
Brady has 	 fav team: Cardinals 	 RedSox friends: 25 	 Cardinals friends: 60
Bradyn has 	 fav team: Red Sox 	 RedSox friends: 51 	 Cardinals friends: 23
Braeden has 	 fav team: Cardinals 	 RedSox friends: 26 	 Cardinals friends: 57
Braelyn has 	 fav team: Red Sox 	 RedSox friends: 56 	 Cardinals friends: 30
Braelynn has 	 fav team: Cardinals 	 RedSox friends: 46 	 Cardinals friends: 51
Braiden has 	 fav team: Red Sox 	 RedSox friends: 53 	 Cardinals friends: 33
Branden has 	 fav team: Cardinals 	 RedSox friends: 24 	 Cardinals friends: 56
Brandon has 	 fav team: Red Sox 	 RedSox friends: 49 	 Cardinals friends: 24
Branson has 	 fav team: Cardinals 	 RedSox friends: 24 	 Cardinals friends: 42
Brantley has 	 fav team: Cardinals 	 RedSox friends: 28 	 Cardinals friends: 37
Braxton has 	 fav team: Red Sox 	 RedSox friends: 48 	 Cardinals friends: 31
Brayan has 	 fav team: Cardinals 	 RedSox friends: 25 	 Cardinals friends: 60
Brayden has 	 fav team: Red Sox 	 RedSox friends: 46 	 Cardinals friends: 31
Braydon has 	 fav team: Red Sox 	 RedSox friends: 51 	 Cardinals friends: 30
Braylee has 	 fav team: Cardinals 	 RedSox friends: 32 	 Cardinals friends: 54
Braylen has 	 fav team: Cardinals 	 RedSox friends: 34 	 Cardinals friends: 53
Braylon has 	 fav team: Cardinals 	 RedSox friends: 23 	 Cardinals friends: 45
Breanna has 	 fav team: Red Sox 	 RedSox friends: 50 	 Cardinals friends: 28
Brecken has 	 fav team: Red Sox 	 RedSox friends: 44 	 Cardinals friends: 34
Bree has 	 fav team: Red Sox 	 RedSox friends: 57 	 Cardinals friends: 35
Brenda has 	 fav team: Cardinals 	 RedSox friends: 28 	 Cardinals friends: 50
Brendan has 	 fav team: Cardinals 	 RedSox friends: 34 	 Cardinals friends: 46
Brenden has 	 fav team: Cardinals 	 RedSox friends: 28 	 Cardinals friends: 46
Brendon has 	 fav team: Red Sox 	 RedSox friends: 47 	 Cardinals friends: 33
Brenna has 	 fav team: Red Sox 	 RedSox friends: 42 	 Cardinals friends: 21
Brennan has 	 fav team: Cardinals 	 RedSox friends: 37 	 Cardinals friends: 53
Brennen has 	 fav team: Red Sox 	 RedSox friends: 45 	 Cardinals friends: 20
Brent has 	 fav team: Red Sox 	 RedSox friends: 44 	 Cardinals friends: 29
Brentley has 	 fav team: Cardinals 	 RedSox friends: 27 	 Cardinals friends: 47
Brenton has 	 fav team: Red Sox 	 RedSox friends: 52 	 Cardinals friends: 32
Brett has 	 fav team: Cardinals 	 RedSox friends: 34 	 Cardinals friends: 63
Bria has 	 fav team: Red Sox 	 RedSox friends: 49 	 Cardinals friends: 32
Brian has 	 fav team: Red Sox 	 RedSox friends: 56 	 Cardinals friends: 34
Briana has 	 fav team: Red Sox 	 RedSox friends: 49 	 Cardinals friends: 31
Brianna has 	 fav team: Red Sox 	 RedSox friends: 46 	 Cardinals friends: 16
Brice has 	 fav team: Red Sox 	 RedSox friends: 48 	 Cardinals friends: 33
Bridger has 	 fav team: Cardinals 	 RedSox friends: 30 	 Cardinals friends: 52
Bridget has 	 fav team: Red Sox 	 RedSox friends: 37 	 Cardinals friends: 28
Briella has 	 fav team: Red Sox 	 RedSox friends: 48 	 Cardinals friends: 31
Brielle has 	 fav team: Red Sox 	 RedSox friends: 52 	 Cardinals friends: 32
Briggs has 	 fav team: Red Sox 	 RedSox friends: 51 	 Cardinals friends: 29
Briley has 	 fav team: Cardinals 	 RedSox friends: 33 	 Cardinals friends: 45
Brinley has 	 fav team: Red Sox 	 RedSox friends: 54 	 Cardinals friends: 35
Brisa has 	 fav team: Cardinals 	 RedSox friends: 31 	 Cardinals friends: 47
Bristol has 	 fav team: Red Sox 	 RedSox friends: 48 	 Cardinals friends: 22
Britney has 	 fav team: Red Sox 	 RedSox friends: 44 	 Cardinals friends: 29
Brittany has 	 fav team: Cardinals 	 RedSox friends: 28 	 Cardinals friends: 50
Brock has 	 fav team: Cardinals 	 RedSox friends: 17 	 Cardinals friends: 38
Broderick has 	 fav team: Cardinals 	 RedSox friends: 27 	 Cardinals friends: 50
Brodie has 	 fav team: Cardinals 	 RedSox friends: 32 	 Cardinals friends: 49
Brody has 	 fav team: Red Sox 	 RedSox friends: 53 	 Cardinals friends: 20
Brogan has 	 fav team: Red Sox 	 RedSox friends: 42 	 Cardinals friends: 26
Bronson has 	 fav team: Red Sox 	 RedSox friends: 49 	 Cardinals friends: 35
Brooke has 	 fav team: Cardinals 	 RedSox friends: 35 	 Cardinals friends: 48
Brooklyn has 	 fav team: Red Sox 	 RedSox friends: 42 	 Cardinals friends: 26
Brooklynn has 	 fav team: Cardinals 	 RedSox friends: 27 	 Cardinals friends: 54
Brooks has 	 fav team: Cardinals 	 RedSox friends: 27 	 Cardinals friends: 41
Bruce has 	 fav team: Red Sox 	 RedSox friends: 52 	 Cardinals friends: 26
Bruno has 	 fav team: Cardinals 	 RedSox friends: 25 	 Cardinals friends: 49
Bryan has 	 fav team: Cardinals 	 RedSox friends: 30 	 Cardinals friends: 46
Bryanna has 	 fav team: Cardinals 	 RedSox friends: 39 	 Cardinals friends: 43
Bryant has 	 fav team: Cardinals 	 RedSox friends: 27 	 Cardinals friends: 49
Bryce has 	 fav team: Red Sox 	 RedSox friends: 57 	 Cardinals friends: 36
Brycen has 	 fav team: Cardinals 	 RedSox friends: 26 	 Cardinals friends: 42
Brylee has 	 fav team: Red Sox 	 RedSox friends: 53 	 Cardinals friends: 27
Bryleigh has 	 fav team: Red Sox 	 RedSox friends: 42 	 Cardinals friends: 27
Bryn has 	 fav team: Red Sox 	 RedSox friends: 46 	 Cardinals friends: 33
Brynlee has 	 fav team: Red Sox 	 RedSox friends: 63 	 Cardinals friends: 27
Brynn has 	 fav team: Red Sox 	 RedSox friends: 42 	 Cardinals friends: 42
Bryson has 	 fav team: Cardinals 	 RedSox friends: 31 	 Cardinals friends: 55
Byron has 	 fav team: Red Sox 	 RedSox friends: 35 	 Cardinals friends: 23
Cade has 	 fav team: Red Sox 	 RedSox friends: 47 	 Cardinals friends: 21
Caden has 	 fav team: Red Sox 	 RedSox friends: 52 	 Cardinals friends: 35
Cadence has 	 fav team: Red Sox 	 RedSox friends: 44 	 Cardinals friends: 32
Cael has 	 fav team: Cardinals 	 RedSox friends: 39 	 Cardinals friends: 54
Caiden has 	 fav team: Red Sox 	 RedSox friends: 49 	 Cardinals friends: 34
Cailyn has 	 fav team: Red Sox 	 RedSox friends: 60 	 Cardinals friends: 26
Cain has 	 fav team: Cardinals 	 RedSox friends: 28 	 Cardinals friends: 45
Caitlin has 	 fav team: Cardinals 	 RedSox friends: 37 	 Cardinals friends: 48
Caitlyn has 	 fav team: Cardinals 	 RedSox friends: 21 	 Cardinals friends: 62
Cale has 	 fav team: Red Sox 	 RedSox friends: 57 	 Cardinals friends: 24
Caleb has 	 fav team: Red Sox 	 RedSox friends: 60 	 Cardinals friends: 30
Cali has 	 fav team: Red Sox 	 RedSox friends: 58 	 Cardinals friends: 33
Callan has 	 fav team: Cardinals 	 RedSox friends: 30 	 Cardinals friends: 47
Callen has 	 fav team: Cardinals 	 RedSox friends: 27 	 Cardinals friends: 37
Callie has 	 fav team: Red Sox 	 RedSox friends: 55 	 Cardinals friends: 28
Callum has 	 fav team: Red Sox 	 RedSox friends: 58 	 Cardinals friends: 24
Calvin has 	 fav team: Red Sox 	 RedSox friends: 68 	 Cardinals friends: 30
Cambria has 	 fav team: Red Sox 	 RedSox friends: 37 	 Cardinals friends: 30
Camden has 	 fav team: Red Sox 	 RedSox friends: 39 	 Cardinals friends: 32
Camdyn has 	 fav team: Red Sox 	 RedSox friends: 58 	 Cardinals friends: 29
Cameron has 	 fav team: Cardinals 	 RedSox friends: 35 	 Cardinals friends: 45
Camila has 	 fav team: Red Sox 	 RedSox friends: 66 	 Cardinals friends: 30
Camilla has 	 fav team: Cardinals 	 RedSox friends: 28 	 Cardinals friends: 41
Camille has 	 fav team: Red Sox 	 RedSox friends: 56 	 Cardinals friends: 35
Camilo has 	 fav team: Cardinals 	 RedSox friends: 36 	 Cardinals friends: 47
Campbell has 	 fav team: Red Sox 	 RedSox friends: 45 	 Cardinals friends: 30
Camren has 	 fav team: Cardinals 	 RedSox friends: 30 	 Cardinals friends: 35
Camron has 	 fav team: Cardinals 	 RedSox friends: 27 	 Cardinals friends: 47
Camryn has 	 fav team: Red Sox 	 RedSox friends: 52 	 Cardinals friends: 31
Cannon has 	 fav team: Cardinals 	 RedSox friends: 26 	 Cardinals friends: 42
Cara has 	 fav team: Red Sox 	 RedSox friends: 46 	 Cardinals friends: 33
Carissa has 	 fav team: Red Sox 	 RedSox friends: 49 	 Cardinals friends: 34
Carl has 	 fav team: Red Sox 	 RedSox friends: 48 	 Cardinals friends: 19
Carla has 	 fav team: Cardinals 	 RedSox friends: 34 	 Cardinals friends: 41
Carlee has 	 fav team: Red Sox 	 RedSox friends: 49 	 Cardinals friends: 39
Carleigh has 	 fav team: Cardinals 	 RedSox friends: 35 	 Cardinals friends: 39
Carley has 	 fav team: Cardinals 	 RedSox friends: 24 	 Cardinals friends: 48
Carlie has 	 fav team: Cardinals 	 RedSox friends: 39 	 Cardinals friends: 51
Carlos has 	 fav team: Cardinals 	 RedSox friends: 24 	 Cardinals friends: 40
Carly has 	 fav team: Cardinals 	 RedSox friends: 37 	 Cardinals friends: 44
Carmelo has 	 fav team: Cardinals 	 RedSox friends: 21 	 Cardinals friends: 46
Carmen has 	 fav team: Cardinals 	 RedSox friends: 29 	 Cardinals friends: 42
Carolina has 	 fav team: Cardinals 	 RedSox friends: 37 	 Cardinals friends: 60
Caroline has 	 fav team: Cardinals 	 RedSox friends: 20 	 Cardinals friends: 60
Carolyn has 	 fav team: Cardinals 	 RedSox friends: 26 	 Cardinals friends: 48
Carson has 	 fav team: Red Sox 	 RedSox friends: 46 	 Cardinals friends: 33
Carter has 	 fav team: Cardinals 	 RedSox friends: 35 	 Cardinals friends: 48
Case has 	 fav team: Red Sox 	 RedSox friends: 54 	 Cardinals friends: 29
Casen has 	 fav team: Cardinals 	 RedSox friends: 35 	 Cardinals friends: 46
Casey has 	 fav team: Red Sox 	 RedSox friends: 60 	 Cardinals friends: 31
Cash has 	 fav team: Cardinals 	 RedSox friends: 29 	 Cardinals friends: 47
Cason has 	 fav team: Red Sox 	 RedSox friends: 45 	 Cardinals friends: 24
Cassandra has 	 fav team: Red Sox 	 RedSox friends: 44 	 Cardinals friends: 20
Cassidy has 	 fav team: Red Sox 	 RedSox friends: 51 	 Cardinals friends: 36
Cassius has 	 fav team: Cardinals 	 RedSox friends: 30 	 Cardinals friends: 40
Cataleya has 	 fav team: Red Sox 	 RedSox friends: 67 	 Cardinals friends: 21
Catalina has 	 fav team: Cardinals 	 RedSox friends: 21 	 Cardinals friends: 46
Catherine has 	 fav team: Red Sox 	 RedSox friends: 53 	 Cardinals friends: 30
Cayden has 	 fav team: Red Sox 	 RedSox friends: 52 	 Cardinals friends: 25
Caylee has 	 fav team: Red Sox 	 RedSox friends: 49 	 Cardinals friends: 32
Cayson has 	 fav team: Cardinals 	 RedSox friends: 37 	 Cardinals friends: 50
Cecelia has 	 fav team: Cardinals 	 RedSox friends: 31 	 Cardinals friends: 45
Cecilia has 	 fav team: Red Sox 	 RedSox friends: 44 	 Cardinals friends: 30
Cedric has 	 fav team: Cardinals 	 RedSox friends: 19 	 Cardinals friends: 48
Celeste has 	 fav team: Cardinals 	 RedSox friends: 28 	 Cardinals friends: 41
Celia has 	 fav team: Red Sox 	 RedSox friends: 48 	 Cardinals friends: 25
Celine has 	 fav team: Cardinals 	 RedSox friends: 23 	 Cardinals friends: 44
Cesar has 	 fav team: Cardinals 	 RedSox friends: 28 	 Cardinals friends: 56
Chace has 	 fav team: Cardinals 	 RedSox friends: 34 	 Cardinals friends: 53
Chad has 	 fav team: Red Sox 	 RedSox friends: 47 	 Cardinals friends: 28
Chaim has 	 fav team: Cardinals 	 RedSox friends: 24 	 Cardinals friends: 47
Chana has 	 fav team: Red Sox 	 RedSox friends: 37 	 Cardinals friends: 30
Chance has 	 fav team: Cardinals 	 RedSox friends: 35 	 Cardinals friends: 48
Chandler has 	 fav team: Cardinals 	 RedSox friends: 21 	 Cardinals friends: 61
Chanel has 	 fav team: Cardinals 	 RedSox friends: 30 	 Cardinals friends: 46
Channing has 	 fav team: Cardinals 	 RedSox friends: 19 	 Cardinals friends: 51
Charity has 	 fav team: Red Sox 	 RedSox friends: 41 	 Cardinals friends: 32
Charlee has 	 fav team: Red Sox 	 RedSox friends: 58 	 Cardinals friends: 28
Charleigh has 	 fav team: Cardinals 	 RedSox friends: 29 	 Cardinals friends: 50
Charles has 	 fav team: Cardinals 	 RedSox friends: 23 	 Cardinals friends: 43
Charley has 	 fav team: Cardinals 	 RedSox friends: 25 	 Cardinals friends: 62
Charli has 	 fav team: Cardinals 	 RedSox friends: 22 	 Cardinals friends: 39
Charlie has 	 fav team: Red Sox 	 RedSox friends: 47 	 Cardinals friends: 31
Charlize has 	 fav team: Red Sox 	 RedSox friends: 41 	 Cardinals friends: 29
Charlotte has 	 fav team: Cardinals 	 RedSox friends: 26 	 Cardinals friends: 41
Chase has 	 fav team: Red Sox 	 RedSox friends: 48 	 Cardinals friends: 21
Chaya has 	 fav team: Cardinals 	 RedSox friends: 27 	 Cardinals friends: 49
Chelsea has 	 fav team: Cardinals 	 RedSox friends: 34 	 Cardinals friends: 42
Cherish has 	 fav team: Cardinals 	 RedSox friends: 29 	 Cardinals friends: 48
Cheyanne has 	 fav team: Red Sox 	 RedSox friends: 44 	 Cardinals friends: 27
Cheyenne has 	 fav team: Red Sox 	 RedSox friends: 51 	 Cardinals friends: 32
Chloe has 	 fav team: Red Sox 	 RedSox friends: 43 	 Cardinals friends: 27
Chris has 	 fav team: Red Sox 	 RedSox friends: 63 	 Cardinals friends: 33
Christian has 	 fav team: Cardinals 	 RedSox friends: 20 	 Cardinals friends: 54
Christina has 	 fav team: Red Sox 	 RedSox friends: 39 	 Cardinals friends: 20
Christine has 	 fav team: Red Sox 	 RedSox friends: 50 	 Cardinals friends: 22
Christopher has 	 fav team: Red Sox 	 RedSox friends: 48 	 Cardinals friends: 24
Ciara has 	 fav team: Cardinals 	 RedSox friends: 26 	 Cardinals friends: 49
Cindy has 	 fav team: Red Sox 	 RedSox friends: 64 	 Cardinals friends: 31
Claire has 	 fav team: Red Sox 	 RedSox friends: 45 	 Cardinals friends: 30
Clara has 	 fav team: Cardinals 	 RedSox friends: 41 	 Cardinals friends: 47
Clare has 	 fav team: Cardinals 	 RedSox friends: 30 	 Cardinals friends: 40
Clarissa has 	 fav team: Red Sox 	 RedSox friends: 53 	 Cardinals friends: 34
Clark has 	 fav team: Cardinals 	 RedSox friends: 30 	 Cardinals friends: 53
Claudia has 	 fav team: Cardinals 	 RedSox friends: 35 	 Cardinals friends: 56
Clay has 	 fav team: Red Sox 	 RedSox friends: 41 	 Cardinals friends: 23
Clayton has 	 fav team: Red Sox 	 RedSox friends: 32 	 Cardinals friends: 27
Clinton has 	 fav team: Red Sox 	 RedSox friends: 41 	 Cardinals friends: 31
Cody has 	 fav team: Red Sox 	 RedSox friends: 53 	 Cardinals friends: 21
Cohen has 	 fav team: Cardinals 	 RedSox friends: 27 	 Cardinals friends: 49
Colby has 	 fav team: Red Sox 	 RedSox friends: 55 	 Cardinals friends: 23
Cole has 	 fav team: Cardinals 	 RedSox friends: 23 	 Cardinals friends: 50
Coleman has 	 fav team: Red Sox 	 RedSox friends: 54 	 Cardinals friends: 25
Colette has 	 fav team: Cardinals 	 RedSox friends: 29 	 Cardinals friends: 36
Colin has 	 fav team: Red Sox 	 RedSox friends: 47 	 Cardinals friends: 27
Collin has 	 fav team: Red Sox 	 RedSox friends: 57 	 Cardinals friends: 35
Collins has 	 fav team: Red Sox 	 RedSox friends: 56 	 Cardinals friends: 24
Colt has 	 fav team: Cardinals 	 RedSox friends: 31 	 Cardinals friends: 32
Colten has 	 fav team: Cardinals 	 RedSox friends: 27 	 Cardinals friends: 46
Colton has 	 fav team: Cardinals 	 RedSox friends: 35 	 Cardinals friends: 47
Conner has 	 fav team: Red Sox 	 RedSox friends: 45 	 Cardinals friends: 37
Connor has 	 fav team: Red Sox 	 RedSox friends: 48 	 Cardinals friends: 31
Conor has 	 fav team: Red Sox 	 RedSox friends: 46 	 Cardinals friends: 23
Conrad has 	 fav team: Cardinals 	 RedSox friends: 22 	 Cardinals friends: 46
Cooper has 	 fav team: Red Sox 	 RedSox friends: 57 	 Cardinals friends: 23
Cora has 	 fav team: Cardinals 	 RedSox friends: 30 	 Cardinals friends: 47
Coraline has 	 fav team: Red Sox 	 RedSox friends: 43 	 Cardinals friends: 29
Corbin has 	 fav team: Cardinals 	 RedSox friends: 36 	 Cardinals friends: 38
Corey has 	 fav team: Cardinals 	 RedSox friends: 23 	 Cardinals friends: 53
Corinne has 	 fav team: Cardinals 	 RedSox friends: 34 	 Cardinals friends: 49
Cory has 	 fav team: Cardinals 	 RedSox friends: 36 	 Cardinals friends: 44
Courtney has 	 fav team: Cardinals 	 RedSox friends: 32 	 Cardinals friends: 53
Craig has 	 fav team: Cardinals 	 RedSox friends: 33 	 Cardinals friends: 33
Crew has 	 fav team: Red Sox 	 RedSox friends: 52 	 Cardinals friends: 30
Cristian has 	 fav team: Cardinals 	 RedSox friends: 21 	 Cardinals friends: 54
Cristina has 	 fav team: Cardinals 	 RedSox friends: 28 	 Cardinals friends: 47
Cristopher has 	 fav team: Cardinals 	 RedSox friends: 25 	 Cardinals friends: 37
Crosby has 	 fav team: Red Sox 	 RedSox friends: 45 	 Cardinals friends: 22
Cruz has 	 fav team: Red Sox 	 RedSox friends: 69 	 Cardinals friends: 28
Crystal has 	 fav team: Cardinals 	 RedSox friends: 28 	 Cardinals friends: 48
Cullen has 	 fav team: Cardinals 	 RedSox friends: 35 	 Cardinals friends: 44
Curtis has 	 fav team: Cardinals 	 RedSox friends: 23 	 Cardinals friends: 48
Cynthia has 	 fav team: Cardinals 	 RedSox friends: 37 	 Cardinals friends: 49
Cyrus has 	 fav team: Red Sox 	 RedSox friends: 51 	 Cardinals friends: 30
Dahlia has 	 fav team: Cardinals 	 RedSox friends: 26 	 Cardinals friends: 46
Daisy has 	 fav team: Cardinals 	 RedSox friends: 25 	 Cardinals friends: 55
Dakota has 	 fav team: Red Sox 	 RedSox friends: 54 	 Cardinals friends: 34
Dalilah has 	 fav team: Red Sox 	 RedSox friends: 48 	 Cardinals friends: 29
Dallas has 	 fav team: Cardinals 	 RedSox friends: 24 	 Cardinals friends: 42
Dalton has 	 fav team: Cardinals 	 RedSox friends: 28 	 Cardinals friends: 42
Damari has 	 fav team: Cardinals 	 RedSox friends: 19 	 Cardinals friends: 59
Damarion has 	 fav team: Red Sox 	 RedSox friends: 43 	 Cardinals friends: 33
Damian has 	 fav team: Red Sox 	 RedSox friends: 43 	 Cardinals friends: 37
Damien has 	 fav team: Cardinals 	 RedSox friends: 30 	 Cardinals friends: 44
Damion has 	 fav team: Cardinals 	 RedSox friends: 28 	 Cardinals friends: 54
Damon has 	 fav team: Red Sox 	 RedSox friends: 47 	 Cardinals friends: 24
Dana has 	 fav team: Red Sox 	 RedSox friends: 55 	 Cardinals friends: 28
Dane has 	 fav team: Red Sox 	 RedSox friends: 44 	 Cardinals friends: 24
Dangelo has 	 fav team: Red Sox 	 RedSox friends: 43 	 Cardinals friends: 36
Danica has 	 fav team: Cardinals 	 RedSox friends: 28 	 Cardinals friends: 35
Daniel has 	 fav team: Red Sox 	 RedSox friends: 37 	 Cardinals friends: 34
Daniela has 	 fav team: Red Sox 	 RedSox friends: 42 	 Cardinals friends: 36
Daniella has 	 fav team: Cardinals 	 RedSox friends: 29 	 Cardinals friends: 56
Danielle has 	 fav team: Red Sox 	 RedSox friends: 49 	 Cardinals friends: 17
Danika has 	 fav team: Cardinals 	 RedSox friends: 34 	 Cardinals friends: 58
Danna has 	 fav team: Cardinals 	 RedSox friends: 30 	 Cardinals friends: 42
Danny has 	 fav team: Cardinals 	 RedSox friends: 33 	 Cardinals friends: 48
Dante has 	 fav team: Cardinals 	 RedSox friends: 34 	 Cardinals friends: 42
Daphne has 	 fav team: Cardinals 	 RedSox friends: 36 	 Cardinals friends: 54
Darian has 	 fav team: Cardinals 	 RedSox friends: 30 	 Cardinals friends: 39
Dariel has 	 fav team: Red Sox 	 RedSox friends: 53 	 Cardinals friends: 24
Darien has 	 fav team: Red Sox 	 RedSox friends: 51 	 Cardinals friends: 29
Dario has 	 fav team: Cardinals 	 RedSox friends: 23 	 Cardinals friends: 48
Darius has 	 fav team: Cardinals 	 RedSox friends: 31 	 Cardinals friends: 52
Darnell has 	 fav team: Red Sox 	 RedSox friends: 44 	 Cardinals friends: 28
Darrell has 	 fav team: Cardinals 	 RedSox friends: 32 	 Cardinals friends: 59
Darren has 	 fav team: Red Sox 	 RedSox friends: 56 	 Cardinals friends: 27
Darryl has 	 fav team: Red Sox 	 RedSox friends: 49 	 Cardinals friends: 27
Darwin has 	 fav team: Cardinals 	 RedSox friends: 31 	 Cardinals friends: 49
Davian has 	 fav team: Cardinals 	 RedSox friends: 33 	 Cardinals friends: 46
David has 	 fav team: Red Sox 	 RedSox friends: 53 	 Cardinals friends: 32
Davin has 	 fav team: Cardinals 	 RedSox friends: 21 	 Cardinals friends: 32
Davion has 	 fav team: Red Sox 	 RedSox friends: 46 	 Cardinals friends: 18
Davis has 	 fav team: Red Sox 	 RedSox friends: 47 	 Cardinals friends: 32
Davon has 	 fav team: Red Sox 	 RedSox friends: 50 	 Cardinals friends: 37
Dawson has 	 fav team: Red Sox 	 RedSox friends: 49 	 Cardinals friends: 28
Dax has 	 fav team: Red Sox 	 RedSox friends: 56 	 Cardinals friends: 26
Daxton has 	 fav team: Red Sox 	 RedSox friends: 47 	 Cardinals friends: 33
Dayana has 	 fav team: Cardinals 	 RedSox friends: 19 	 Cardinals friends: 49
Dayton has 	 fav team: Cardinals 	 RedSox friends: 25 	 Cardinals friends: 47
Deacon has 	 fav team: Cardinals 	 RedSox friends: 30 	 Cardinals friends: 48
Dean has 	 fav team: Cardinals 	 RedSox friends: 30 	 Cardinals friends: 31
Deandre has 	 fav team: Cardinals 	 RedSox friends: 27 	 Cardinals friends: 55
Deangelo has 	 fav team: Red Sox 	 RedSox friends: 54 	 Cardinals friends: 36
Deanna has 	 fav team: Cardinals 	 RedSox friends: 24 	 Cardinals friends: 52
Deborah has 	 fav team: Red Sox 	 RedSox friends: 48 	 Cardinals friends: 37
Declan has 	 fav team: Red Sox 	 RedSox friends: 58 	 Cardinals friends: 25
Deegan has 	 fav team: Cardinals 	 RedSox friends: 24 	 Cardinals friends: 47
Delaney has 	 fav team: Cardinals 	 RedSox friends: 27 	 Cardinals friends: 59
Delilah has 	 fav team: Red Sox 	 RedSox friends: 45 	 Cardinals friends: 20
Demarcus has 	 fav team: Red Sox 	 RedSox friends: 34 	 Cardinals friends: 29
Demetrius has 	 fav team: Red Sox 	 RedSox friends: 52 	 Cardinals friends: 25
Demi has 	 fav team: Red Sox 	 RedSox friends: 49 	 Cardinals friends: 23
Denise has 	 fav team: Cardinals 	 RedSox friends: 17 	 Cardinals friends: 47
Dennis has 	 fav team: Red Sox 	 RedSox friends: 46 	 Cardinals friends: 27
Denzel has 	 fav team: Cardinals 	 RedSox friends: 18 	 Cardinals friends: 43
Deon has 	 fav team: Cardinals 	 RedSox friends: 36 	 Cardinals friends: 55
Derek has 	 fav team: Red Sox 	 RedSox friends: 52 	 Cardinals friends: 22
Derick has 	 fav team: Cardinals 	 RedSox friends: 29 	 Cardinals friends: 37
Derrick has 	 fav team: Red Sox 	 RedSox friends: 45 	 Cardinals friends: 38
Deshawn has 	 fav team: Red Sox 	 RedSox friends: 43 	 Cardinals friends: 32
Desiree has 	 fav team: Red Sox 	 RedSox friends: 44 	 Cardinals friends: 31
Desmond has 	 fav team: Red Sox 	 RedSox friends: 50 	 Cardinals friends: 32
Destinee has 	 fav team: Cardinals 	 RedSox friends: 25 	 Cardinals friends: 52
Destiny has 	 fav team: Red Sox 	 RedSox friends: 50 	 Cardinals friends: 23
Devan has 	 fav team: Cardinals 	 RedSox friends: 36 	 Cardinals friends: 42
Devin has 	 fav team: Red Sox 	 RedSox friends: 44 	 Cardinals friends: 34
Devon has 	 fav team: Red Sox 	 RedSox friends: 43 	 Cardinals friends: 27
Devyn has 	 fav team: Red Sox 	 RedSox friends: 47 	 Cardinals friends: 27
Dexter has 	 fav team: Cardinals 	 RedSox friends: 29 	 Cardinals friends: 42
Diamond has 	 fav team: Red Sox 	 RedSox friends: 53 	 Cardinals friends: 26
Diana has 	 fav team: Red Sox 	 RedSox friends: 45 	 Cardinals friends: 29
Diego has 	 fav team: Red Sox 	 RedSox friends: 45 	 Cardinals friends: 20
Dillon has 	 fav team: Cardinals 	 RedSox friends: 27 	 Cardinals friends: 59
Dixie has 	 fav team: Cardinals 	 RedSox friends: 32 	 Cardinals friends: 38
Dominic has 	 fav team: Red Sox 	 RedSox friends: 51 	 Cardinals friends: 33
Dominick has 	 fav team: Red Sox 	 RedSox friends: 47 	 Cardinals friends: 24
Dominik has 	 fav team: Red Sox 	 RedSox friends: 49 	 Cardinals friends: 29
Dominique has 	 fav team: Red Sox 	 RedSox friends: 59 	 Cardinals friends: 40
Donald has 	 fav team: Cardinals 	 RedSox friends: 35 	 Cardinals friends: 39
Donovan has 	 fav team: Red Sox 	 RedSox friends: 44 	 Cardinals friends: 33
Donte has 	 fav team: Cardinals 	 RedSox friends: 31 	 Cardinals friends: 51
Dorian has 	 fav team: Red Sox 	 RedSox friends: 53 	 Cardinals friends: 32
Dorothy has 	 fav team: Red Sox 	 RedSox friends: 41 	 Cardinals friends: 34
Douglas has 	 fav team: Red Sox 	 RedSox friends: 52 	 Cardinals friends: 33
Drake has 	 fav team: Cardinals 	 RedSox friends: 30 	 Cardinals friends: 48
Draven has 	 fav team: Cardinals 	 RedSox friends: 28 	 Cardinals friends: 48
Drew has 	 fav team: Red Sox 	 RedSox friends: 50 	 Cardinals friends: 31
Dulce has 	 fav team: Red Sox 	 RedSox friends: 44 	 Cardinals friends: 26
Duncan has 	 fav team: Red Sox 	 RedSox friends: 40 	 Cardinals friends: 26
Dustin has 	 fav team: Red Sox 	 RedSox friends: 39 	 Cardinals friends: 18
Dwayne has 	 fav team: Red Sox 	 RedSox friends: 46 	 Cardinals friends: 28
Dylan has 	 fav team: Cardinals 	 RedSox friends: 30 	 Cardinals friends: 40
Ean has 	 fav team: Cardinals 	 RedSox friends: 29 	 Cardinals friends: 49
Easton has 	 fav team: Cardinals 	 RedSox friends: 23 	 Cardinals friends: 47
Eddie has 	 fav team: Red Sox 	 RedSox friends: 44 	 Cardinals friends: 33
Eden has 	 fav team: Red Sox 	 RedSox friends: 50 	 Cardinals friends: 41
Edgar has 	 fav team: Red Sox 	 RedSox friends: 53 	 Cardinals friends: 30
Edison has 	 fav team: Red Sox 	 RedSox friends: 53 	 Cardinals friends: 23
Edith has 	 fav team: Red Sox 	 RedSox friends: 48 	 Cardinals friends: 29
Eduardo has 	 fav team: Red Sox 	 RedSox friends: 40 	 Cardinals friends: 27
Edward has 	 fav team: Red Sox 	 RedSox friends: 54 	 Cardinals friends: 31
Edwin has 	 fav team: Cardinals 	 RedSox friends: 36 	 Cardinals friends: 60
Efrain has 	 fav team: Red Sox 	 RedSox friends: 42 	 Cardinals friends: 35
Eileen has 	 fav team: Red Sox 	 RedSox friends: 58 	 Cardinals friends: 31
Elaina has 	 fav team: Red Sox 	 RedSox friends: 45 	 Cardinals friends: 24
Elaine has 	 fav team: Red Sox 	 RedSox friends: 46 	 Cardinals friends: 35
Eleanor has 	 fav team: Cardinals 	 RedSox friends: 27 	 Cardinals friends: 51
Elena has 	 fav team: Cardinals 	 RedSox friends: 30 	 Cardinals friends: 51
Eli has 	 fav team: Cardinals 	 RedSox friends: 27 	 Cardinals friends: 48
Elian has 	 fav team: Red Sox 	 RedSox friends: 47 	 Cardinals friends: 34
Eliana has 	 fav team: Red Sox 	 RedSox friends: 38 	 Cardinals friends: 37
Elianna has 	 fav team: Red Sox 	 RedSox friends: 46 	 Cardinals friends: 33
Elias has 	 fav team: Cardinals 	 RedSox friends: 25 	 Cardinals friends: 47
Elijah has 	 fav team: Cardinals 	 RedSox friends: 28 	 Cardinals friends: 50
Elin has 	 fav team: Cardinals 	 RedSox friends: 18 	 Cardinals friends: 39
Eliot has 	 fav team: Cardinals 	 RedSox friends: 26 	 Cardinals friends: 58
Elisa has 	 fav team: Red Sox 	 RedSox friends: 59 	 Cardinals friends: 30
Elisabeth has 	 fav team: Red Sox 	 RedSox friends: 55 	 Cardinals friends: 39
Elise has 	 fav team: Cardinals 	 RedSox friends: 22 	 Cardinals friends: 47
Eliseo has 	 fav team: Cardinals 	 RedSox friends: 41 	 Cardinals friends: 41
Elisha has 	 fav team: Red Sox 	 RedSox friends: 48 	 Cardinals friends: 21
Elissa has 	 fav team: Red Sox 	 RedSox friends: 45 	 Cardinals friends: 31
Eliza has 	 fav team: Red Sox 	 RedSox friends: 40 	 Cardinals friends: 24
Elizabeth has 	 fav team: Red Sox 	 RedSox friends: 50 	 Cardinals friends: 29
Ella has 	 fav team: Red Sox 	 RedSox friends: 50 	 Cardinals friends: 20
Elle has 	 fav team: Red Sox 	 RedSox friends: 46 	 Cardinals friends: 38
Ellen has 	 fav team: Red Sox 	 RedSox friends: 50 	 Cardinals friends: 20
Elliana has 	 fav team: Cardinals 	 RedSox friends: 38 	 Cardinals friends: 54
Ellie has 	 fav team: Red Sox 	 RedSox friends: 50 	 Cardinals friends: 27
Elliot has 	 fav team: Cardinals 	 RedSox friends: 20 	 Cardinals friends: 45
Elliott has 	 fav team: Cardinals 	 RedSox friends: 31 	 Cardinals friends: 41
Ellis has 	 fav team: Red Sox 	 RedSox friends: 47 	 Cardinals friends: 27
Eloise has 	 fav team: Red Sox 	 RedSox friends: 42 	 Cardinals friends: 40
Elsa has 	 fav team: Cardinals 	 RedSox friends: 37 	 Cardinals friends: 44
Elsie has 	 fav team: Cardinals 	 RedSox friends: 26 	 Cardinals friends: 40
Elyse has 	 fav team: Cardinals 	 RedSox friends: 32 	 Cardinals friends: 57
Emanuel has 	 fav team: Cardinals 	 RedSox friends: 29 	 Cardinals friends: 54
Ember has 	 fav team: Red Sox 	 RedSox friends: 55 	 Cardinals friends: 29
Emelia has 	 fav team: Red Sox 	 RedSox friends: 54 	 Cardinals friends: 26
Emely has 	 fav team: Cardinals 	 RedSox friends: 26 	 Cardinals friends: 56
Emerson has 	 fav team: Red Sox 	 RedSox friends: 51 	 Cardinals friends: 25
Emersyn has 	 fav team: Red Sox 	 RedSox friends: 50 	 Cardinals friends: 25
Emery has 	 fav team: Red Sox 	 RedSox friends: 58 	 Cardinals friends: 19
Emilee has 	 fav team: Red Sox 	 RedSox friends: 63 	 Cardinals friends: 37
Emilia has 	 fav team: Cardinals 	 RedSox friends: 32 	 Cardinals friends: 38
Emiliano has 	 fav team: Cardinals 	 RedSox friends: 17 	 Cardinals friends: 53
Emilie has 	 fav team: Red Sox 	 RedSox friends: 47 	 Cardinals friends: 33
Emilio has 	 fav team: Cardinals 	 RedSox friends: 28 	 Cardinals friends: 45
Emily has 	 fav team: Red Sox 	 RedSox friends: 47 	 Cardinals friends: 34
Emma has 	 fav team: Cardinals 	 RedSox friends: 25 	 Cardinals friends: 54
Emmalee has 	 fav team: Red Sox 	 RedSox friends: 42 	 Cardinals friends: 26
Emmaline has 	 fav team: Red Sox 	 RedSox friends: 60 	 Cardinals friends: 27
Emmalyn has 	 fav team: Red Sox 	 RedSox friends: 44 	 Cardinals friends: 33
Emmalynn has 	 fav team: Cardinals 	 RedSox friends: 27 	 Cardinals friends: 54
Emmanuel has 	 fav team: Cardinals 	 RedSox friends: 17 	 Cardinals friends: 39
Emmett has 	 fav team: Red Sox 	 RedSox friends: 62 	 Cardinals friends: 17
Emmitt has 	 fav team: Cardinals 	 RedSox friends: 28 	 Cardinals friends: 53
Emmy has 	 fav team: Red Sox 	 RedSox friends: 54 	 Cardinals friends: 31
Emory has 	 fav team: Red Sox 	 RedSox friends: 45 	 Cardinals friends: 33
Enrique has 	 fav team: Cardinals 	 RedSox friends: 27 	 Cardinals friends: 56
Enzo has 	 fav team: Cardinals 	 RedSox friends: 24 	 Cardinals friends: 44
Eric has 	 fav team: Red Sox 	 RedSox friends: 51 	 Cardinals friends: 26
Erica has 	 fav team: Red Sox 	 RedSox friends: 42 	 Cardinals friends: 37
Erick has 	 fav team: Red Sox 	 RedSox friends: 47 	 Cardinals friends: 32
Erik has 	 fav team: Cardinals 	 RedSox friends: 32 	 Cardinals friends: 49
Erika has 	 fav team: Cardinals 	 RedSox friends: 26 	 Cardinals friends: 44
Erin has 	 fav team: Red Sox 	 RedSox friends: 43 	 Cardinals friends: 29
Ernest has 	 fav team: Cardinals 	 RedSox friends: 39 	 Cardinals friends: 44
Ernesto has 	 fav team: Cardinals 	 RedSox friends: 24 	 Cardinals friends: 61
Esme has 	 fav team: Red Sox 	 RedSox friends: 45 	 Cardinals friends: 25
Esmeralda has 	 fav team: Cardinals 	 RedSox friends: 27 	 Cardinals friends: 50
Esteban has 	 fav team: Red Sox 	 RedSox friends: 52 	 Cardinals friends: 29
Estella has 	 fav team: Red Sox 	 RedSox friends: 41 	 Cardinals friends: 28
Estelle has 	 fav team: Red Sox 	 RedSox friends: 53 	 Cardinals friends: 39
Esther has 	 fav team: Cardinals 	 RedSox friends: 33 	 Cardinals friends: 44
Estrella has 	 fav team: Red Sox 	 RedSox friends: 41 	 Cardinals friends: 26
Ethan has 	 fav team: Red Sox 	 RedSox friends: 44 	 Cardinals friends: 21
Eugene has 	 fav team: Cardinals 	 RedSox friends: 28 	 Cardinals friends: 51
Eva has 	 fav team: Red Sox 	 RedSox friends: 54 	 Cardinals friends: 29
Evalyn has 	 fav team: Cardinals 	 RedSox friends: 26 	 Cardinals friends: 50
Evan has 	 fav team: Cardinals 	 RedSox friends: 31 	 Cardinals friends: 36
Evangeline has 	 fav team: Cardinals 	 RedSox friends: 25 	 Cardinals friends: 56
Eve has 	 fav team: Red Sox 	 RedSox friends: 62 	 Cardinals friends: 32
Evelyn has 	 fav team: Red Sox 	 RedSox friends: 54 	 Cardinals friends: 23
Evelynn has 	 fav team: Red Sox 	 RedSox friends: 57 	 Cardinals friends: 25
Everett has 	 fav team: Cardinals 	 RedSox friends: 36 	 Cardinals friends: 53
Everly has 	 fav team: Cardinals 	 RedSox friends: 28 	 Cardinals friends: 41
Evie has 	 fav team: Red Sox 	 RedSox friends: 39 	 Cardinals friends: 35
Ezekiel has 	 fav team: Cardinals 	 RedSox friends: 27 	 Cardinals friends: 56
Ezequiel has 	 fav team: Red Sox 	 RedSox friends: 47 	 Cardinals friends: 32
Ezra has 	 fav team: Cardinals 	 RedSox friends: 35 	 Cardinals friends: 45
Fabian has 	 fav team: Cardinals 	 RedSox friends: 23 	 Cardinals friends: 48
Faith has 	 fav team: Cardinals 	 RedSox friends: 35 	 Cardinals friends: 36
Farrah has 	 fav team: Red Sox 	 RedSox friends: 48 	 Cardinals friends: 36
Fatima has 	 fav team: Cardinals 	 RedSox friends: 28 	 Cardinals friends: 46
Felicity has 	 fav team: Cardinals 	 RedSox friends: 26 	 Cardinals friends: 51
Felipe has 	 fav team: Red Sox 	 RedSox friends: 51 	 Cardinals friends: 37
Felix has 	 fav team: Cardinals 	 RedSox friends: 23 	 Cardinals friends: 41
Fernanda has 	 fav team: Cardinals 	 RedSox friends: 18 	 Cardinals friends: 51
Fernando has 	 fav team: Cardinals 	 RedSox friends: 29 	 Cardinals friends: 52
Finley has 	 fav team: Red Sox 	 RedSox friends: 45 	 Cardinals friends: 22
Finn has 	 fav team: Red Sox 	 RedSox friends: 39 	 Cardinals friends: 35
Finnegan has 	 fav team: Red Sox 	 RedSox friends: 59 	 Cardinals friends: 42
Fiona has 	 fav team: Red Sox 	 RedSox friends: 59 	 Cardinals friends: 31
Fisher has 	 fav team: Cardinals 	 RedSox friends: 32 	 Cardinals friends: 50
Fletcher has 	 fav team: Cardinals 	 RedSox friends: 28 	 Cardinals friends: 52
Flynn has 	 fav team: Red Sox 	 RedSox friends: 53 	 Cardinals friends: 21
Foster has 	 fav team: Cardinals 	 RedSox friends: 38 	 Cardinals friends: 40
Frances has 	 fav team: Red Sox 	 RedSox friends: 49 	 Cardinals friends: 21
Francesca has 	 fav team: Cardinals 	 RedSox friends: 26 	 Cardinals friends: 51
Francis has 	 fav team: Cardinals 	 RedSox friends: 28 	 Cardinals friends: 54
Francisco has 	 fav team: Red Sox 	 RedSox friends: 47 	 Cardinals friends: 28
Franco has 	 fav team: Cardinals 	 RedSox friends: 36 	 Cardinals friends: 48
Frank has 	 fav team: Red Sox 	 RedSox friends: 48 	 Cardinals friends: 33
Frankie has 	 fav team: Red Sox 	 RedSox friends: 54 	 Cardinals friends: 33
Franklin has 	 fav team: Red Sox 	 RedSox friends: 51 	 Cardinals friends: 33
Freddy has 	 fav team: Cardinals 	 RedSox friends: 36 	 Cardinals friends: 43
Frederick has 	 fav team: Cardinals 	 RedSox friends: 28 	 Cardinals friends: 38
Gabriel has 	 fav team: Red Sox 	 RedSox friends: 41 	 Cardinals friends: 33
Gabriela has 	 fav team: Red Sox 	 RedSox friends: 54 	 Cardinals friends: 30
Gabriella has 	 fav team: Cardinals 	 RedSox friends: 30 	 Cardinals friends: 38
Gabrielle has 	 fav team: Red Sox 	 RedSox friends: 44 	 Cardinals friends: 25
Gael has 	 fav team: Red Sox 	 RedSox friends: 46 	 Cardinals friends: 26
Gage has 	 fav team: Cardinals 	 RedSox friends: 33 	 Cardinals friends: 40
Gaige has 	 fav team: Red Sox 	 RedSox friends: 43 	 Cardinals friends: 29
Galilea has 	 fav team: Cardinals 	 RedSox friends: 43 	 Cardinals friends: 66
Garrett has 	 fav team: Cardinals 	 RedSox friends: 37 	 Cardinals friends: 44
Gary has 	 fav team: Red Sox 	 RedSox friends: 57 	 Cardinals friends: 30
Gauge has 	 fav team: Cardinals 	 RedSox friends: 23 	 Cardinals friends: 43
Gavin has 	 fav team: Red Sox 	 RedSox friends: 47 	 Cardinals friends: 34
Gavyn has 	 fav team: Red Sox 	 RedSox friends: 48 	 Cardinals friends: 28
Gemma has 	 fav team: Cardinals 	 RedSox friends: 29 	 Cardinals friends: 53
Genesis has 	 fav team: Red Sox 	 RedSox friends: 58 	 Cardinals friends: 27
Genevieve has 	 fav team: Red Sox 	 RedSox friends: 41 	 Cardinals friends: 29
George has 	 fav team: Red Sox 	 RedSox friends: 44 	 Cardinals friends: 27
Georgia has 	 fav team: Red Sox 	 RedSox friends: 34 	 Cardinals friends: 28
Gerald has 	 fav team: Red Sox 	 RedSox friends: 54 	 Cardinals friends: 29
Geraldine has 	 fav team: Red Sox 	 RedSox friends: 48 	 Cardinals friends: 24
Gerardo has 	 fav team: Red Sox 	 RedSox friends: 37 	 Cardinals friends: 28
Gia has 	 fav team: Red Sox 	 RedSox friends: 49 	 Cardinals friends: 22
Giada has 	 fav team: Red Sox 	 RedSox friends: 55 	 Cardinals friends: 27
Giana has 	 fav team: Red Sox 	 RedSox friends: 52 	 Cardinals friends: 24
Giancarlo has 	 fav team: Cardinals 	 RedSox friends: 33 	 Cardinals friends: 45
Gianna has 	 fav team: Red Sox 	 RedSox friends: 44 	 Cardinals friends: 26
Gianni has 	 fav team: Cardinals 	 RedSox friends: 25 	 Cardinals friends: 52
Gibson has 	 fav team: Red Sox 	 RedSox friends: 51 	 Cardinals friends: 26
Gideon has 	 fav team: Red Sox 	 RedSox friends: 54 	 Cardinals friends: 24
Gilbert has 	 fav team: Red Sox 	 RedSox friends: 46 	 Cardinals friends: 33
Gilberto has 	 fav team: Red Sox 	 RedSox friends: 62 	 Cardinals friends: 38
Giovani has 	 fav team: Cardinals 	 RedSox friends: 25 	 Cardinals friends: 59
Giovanna has 	 fav team: Red Sox 	 RedSox friends: 40 	 Cardinals friends: 21
Giovanni has 	 fav team: Red Sox 	 RedSox friends: 54 	 Cardinals friends: 33
Giovanny has 	 fav team: Red Sox 	 RedSox friends: 53 	 Cardinals friends: 23
Giselle has 	 fav team: Red Sox 	 RedSox friends: 44 	 Cardinals friends: 30
Gisselle has 	 fav team: Cardinals 	 RedSox friends: 22 	 Cardinals friends: 44
Giuliana has 	 fav team: Red Sox 	 RedSox friends: 39 	 Cardinals friends: 26
Gloria has 	 fav team: Red Sox 	 RedSox friends: 58 	 Cardinals friends: 30
Grace has 	 fav team: Red Sox 	 RedSox friends: 41 	 Cardinals friends: 28
Gracelyn has 	 fav team: Cardinals 	 RedSox friends: 16 	 Cardinals friends: 58
Gracelynn has 	 fav team: Red Sox 	 RedSox friends: 54 	 Cardinals friends: 36
Gracie has 	 fav team: Red Sox 	 RedSox friends: 51 	 Cardinals friends: 29
Grady has 	 fav team: Cardinals 	 RedSox friends: 18 	 Cardinals friends: 52
Graeme has 	 fav team: Cardinals 	 RedSox friends: 39 	 Cardinals friends: 46
Graham has 	 fav team: Cardinals 	 RedSox friends: 20 	 Cardinals friends: 54
Grant has 	 fav team: Red Sox 	 RedSox friends: 52 	 Cardinals friends: 27
Graysen has 	 fav team: Cardinals 	 RedSox friends: 39 	 Cardinals friends: 49
Grayson has 	 fav team: Red Sox 	 RedSox friends: 50 	 Cardinals friends: 35
Gregory has 	 fav team: Cardinals 	 RedSox friends: 39 	 Cardinals friends: 41
Greta has 	 fav team: Red Sox 	 RedSox friends: 45 	 Cardinals friends: 33
Greyson has 	 fav team: Cardinals 	 RedSox friends: 33 	 Cardinals friends: 33
Griffin has 	 fav team: Cardinals 	 RedSox friends: 31 	 Cardinals friends: 53
Guadalupe has 	 fav team: Cardinals 	 RedSox friends: 28 	 Cardinals friends: 53
Guillermo has 	 fav team: Cardinals 	 RedSox friends: 31 	 Cardinals friends: 49
Gunnar has 	 fav team: Red Sox 	 RedSox friends: 36 	 Cardinals friends: 31
Gunner has 	 fav team: Red Sox 	 RedSox friends: 54 	 Cardinals friends: 28
Gustavo has 	 fav team: Cardinals 	 RedSox friends: 33 	 Cardinals friends: 47
Gwendolyn has 	 fav team: Red Sox 	 RedSox friends: 48 	 Cardinals friends: 32
Hadassah has 	 fav team: Cardinals 	 RedSox friends: 27 	 Cardinals friends: 55
Hadley has 	 fav team: Red Sox 	 RedSox friends: 51 	 Cardinals friends: 14
Hailee has 	 fav team: Cardinals 	 RedSox friends: 31 	 Cardinals friends: 52
Hailey has 	 fav team: Cardinals 	 RedSox friends: 37 	 Cardinals friends: 54
Haleigh has 	 fav team: Red Sox 	 RedSox friends: 47 	 Cardinals friends: 29
Haley has 	 fav team: Cardinals 	 RedSox friends: 30 	 Cardinals friends: 43
Halle has 	 fav team: Cardinals 	 RedSox friends: 31 	 Cardinals friends: 43
Hallie has 	 fav team: Cardinals 	 RedSox friends: 23 	 Cardinals friends: 53
Hamza has 	 fav team: Cardinals 	 RedSox friends: 23 	 Cardinals friends: 53
Hana has 	 fav team: Cardinals 	 RedSox friends: 23 	 Cardinals friends: 54
Hank has 	 fav team: Red Sox 	 RedSox friends: 55 	 Cardinals friends: 24
Hanna has 	 fav team: Cardinals 	 RedSox friends: 28 	 Cardinals friends: 47
Hannah has 	 fav team: Red Sox 	 RedSox friends: 45 	 Cardinals friends: 30
Harlee has 	 fav team: Red Sox 	 RedSox friends: 37 	 Cardinals friends: 36
Harley has 	 fav team: Cardinals 	 RedSox friends: 27 	 Cardinals friends: 61
Harlow has 	 fav team: Cardinals 	 RedSox friends: 26 	 Cardinals friends: 41
Harmony has 	 fav team: Red Sox 	 RedSox friends: 34 	 Cardinals friends: 28
Harold has 	 fav team: Cardinals 	 RedSox friends: 43 	 Cardinals friends: 53
Harper has 	 fav team: Red Sox 	 RedSox friends: 47 	 Cardinals friends: 31
Harrison has 	 fav team: Cardinals 	 RedSox friends: 27 	 Cardinals friends: 49
Harry has 	 fav team: Cardinals 	 RedSox friends: 27 	 Cardinals friends: 52
Harvey has 	 fav team: Red Sox 	 RedSox friends: 50 	 Cardinals friends: 28
Hassan has 	 fav team: Cardinals 	 RedSox friends: 35 	 Cardinals friends: 53
Hattie has 	 fav team: Red Sox 	 RedSox friends: 48 	 Cardinals friends: 25
Haven has 	 fav team: Cardinals 	 RedSox friends: 27 	 Cardinals friends: 46
Hayden has 	 fav team: Cardinals 	 RedSox friends: 27 	 Cardinals friends: 55
Hayes has 	 fav team: Cardinals 	 RedSox friends: 35 	 Cardinals friends: 48
Haylee has 	 fav team: Red Sox 	 RedSox friends: 41 	 Cardinals friends: 28
Hayleigh has 	 fav team: Red Sox 	 RedSox friends: 52 	 Cardinals friends: 26
Hayley has 	 fav team: Red Sox 	 RedSox friends: 42 	 Cardinals friends: 34
Haylie has 	 fav team: Red Sox 	 RedSox friends: 55 	 Cardinals friends: 34
Hazel has 	 fav team: Cardinals 	 RedSox friends: 36 	 Cardinals friends: 41
Heath has 	 fav team: Red Sox 	 RedSox friends: 46 	 Cardinals friends: 25
Heather has 	 fav team: Cardinals 	 RedSox friends: 27 	 Cardinals friends: 63
Heaven has 	 fav team: Cardinals 	 RedSox friends: 39 	 Cardinals friends: 43
Hector has 	 fav team: Red Sox 	 RedSox friends: 49 	 Cardinals friends: 25
Heidi has 	 fav team: Cardinals 	 RedSox friends: 35 	 Cardinals friends: 47
Helen has 	 fav team: Red Sox 	 RedSox friends: 58 	 Cardinals friends: 23
Helena has 	 fav team: Red Sox 	 RedSox friends: 53 	 Cardinals friends: 30
Hendrix has 	 fav team: Cardinals 	 RedSox friends: 19 	 Cardinals friends: 49
Henry has 	 fav team: Red Sox 	 RedSox friends: 49 	 Cardinals friends: 33
Hezekiah has 	 fav team: Red Sox 	 RedSox friends: 49 	 Cardinals friends: 36
Holden has 	 fav team: Cardinals 	 RedSox friends: 29 	 Cardinals friends: 44
Holly has 	 fav team: Cardinals 	 RedSox friends: 31 	 Cardinals friends: 52
Hope has 	 fav team: Red Sox 	 RedSox friends: 45 	 Cardinals friends: 29
Houston has 	 fav team: Red Sox 	 RedSox friends: 41 	 Cardinals friends: 27
Howard has 	 fav team: Red Sox 	 RedSox friends: 58 	 Cardinals friends: 33
Hudson has 	 fav team: Cardinals 	 RedSox friends: 35 	 Cardinals friends: 48
Hugh has 	 fav team: Red Sox 	 RedSox friends: 48 	 Cardinals friends: 31
Hugo has 	 fav team: Cardinals 	 RedSox friends: 30 	 Cardinals friends: 48
Hunter has 	 fav team: Red Sox 	 RedSox friends: 58 	 Cardinals friends: 21
Ian has 	 fav team: Red Sox 	 RedSox friends: 55 	 Cardinals friends: 29
Ibrahim has 	 fav team: Red Sox 	 RedSox friends: 34 	 Cardinals friends: 37
Ignacio has 	 fav team: Cardinals 	 RedSox friends: 24 	 Cardinals friends: 57
Iker has 	 fav team: Cardinals 	 RedSox friends: 30 	 Cardinals friends: 45
Iliana has 	 fav team: Red Sox 	 RedSox friends: 46 	 Cardinals friends: 29
Imani has 	 fav team: Cardinals 	 RedSox friends: 25 	 Cardinals friends: 53
Immanuel has 	 fav team: Red Sox 	 RedSox friends: 55 	 Cardinals friends: 34
Ingrid has 	 fav team: Red Sox 	 RedSox friends: 45 	 Cardinals friends: 23
Irene has 	 fav team: Cardinals 	 RedSox friends: 33 	 Cardinals friends: 43
Iris has 	 fav team: Red Sox 	 RedSox friends: 49 	 Cardinals friends: 20
Isaac has 	 fav team: Cardinals 	 RedSox friends: 13 	 Cardinals friends: 55
Isabel has 	 fav team: Cardinals 	 RedSox friends: 30 	 Cardinals friends: 47
Isabela has 	 fav team: Red Sox 	 RedSox friends: 51 	 Cardinals friends: 28
Isabella has 	 fav team: Red Sox 	 RedSox friends: 56 	 Cardinals friends: 30
Isabelle has 	 fav team: Cardinals 	 RedSox friends: 42 	 Cardinals friends: 46
Isai has 	 fav team: Red Sox 	 RedSox friends: 48 	 Cardinals friends: 30
Isaiah has 	 fav team: Cardinals 	 RedSox friends: 38 	 Cardinals friends: 50
Isaias has 	 fav team: Cardinals 	 RedSox friends: 28 	 Cardinals friends: 46
Ishaan has 	 fav team: Red Sox 	 RedSox friends: 47 	 Cardinals friends: 38
Isiah has 	 fav team: Cardinals 	 RedSox friends: 20 	 Cardinals friends: 50
Isis has 	 fav team: Red Sox 	 RedSox friends: 50 	 Cardinals friends: 34
Isla has 	 fav team: Cardinals 	 RedSox friends: 27 	 Cardinals friends: 52
Ismael has 	 fav team: Red Sox 	 RedSox friends: 51 	 Cardinals friends: 23
Israel has 	 fav team: Red Sox 	 RedSox friends: 43 	 Cardinals friends: 26
Issac has 	 fav team: Red Sox 	 RedSox friends: 57 	 Cardinals friends: 33
Itzel has 	 fav team: Red Sox 	 RedSox friends: 40 	 Cardinals friends: 28
Ivan has 	 fav team: Red Sox 	 RedSox friends: 47 	 Cardinals friends: 25
Ivanna has 	 fav team: Red Sox 	 RedSox friends: 47 	 Cardinals friends: 30
Ivy has 	 fav team: Cardinals 	 RedSox friends: 26 	 Cardinals friends: 50
Izabella has 	 fav team: Red Sox 	 RedSox friends: 52 	 Cardinals friends: 25
Izabelle has 	 fav team: Red Sox 	 RedSox friends: 44 	 Cardinals friends: 32
Izaiah has 	 fav team: Cardinals 	 RedSox friends: 26 	 Cardinals friends: 40
Izayah has 	 fav team: Red Sox 	 RedSox friends: 48 	 Cardinals friends: 34
Jabari has 	 fav team: Red Sox 	 RedSox friends: 44 	 Cardinals friends: 39
Jace has 	 fav team: Red Sox 	 RedSox friends: 50 	 Cardinals friends: 42
Jack has 	 fav team: Red Sox 	 RedSox friends: 63 	 Cardinals friends: 36
Jackson has 	 fav team: Red Sox 	 RedSox friends: 42 	 Cardinals friends: 34
Jacob has 	 fav team: Cardinals 	 RedSox friends: 35 	 Cardinals friends: 48
Jacoby has 	 fav team: Red Sox 	 RedSox friends: 42 	 Cardinals friends: 37
Jacqueline has 	 fav team: Red Sox 	 RedSox friends: 57 	 Cardinals friends: 40
Jada has 	 fav team: Cardinals 	 RedSox friends: 27 	 Cardinals friends: 58
Jade has 	 fav team: Cardinals 	 RedSox friends: 31 	 Cardinals friends: 43
Jaden has 	 fav team: Cardinals 	 RedSox friends: 37 	 Cardinals friends: 43
Jadiel has 	 fav team: Red Sox 	 RedSox friends: 56 	 Cardinals friends: 34
Jadon has 	 fav team: Red Sox 	 RedSox friends: 57 	 Cardinals friends: 25
Jaeden has 	 fav team: Cardinals 	 RedSox friends: 19 	 Cardinals friends: 49
Jael has 	 fav team: Red Sox 	 RedSox friends: 47 	 Cardinals friends: 28
Jaelyn has 	 fav team: Red Sox 	 RedSox friends: 51 	 Cardinals friends: 28
Jaelynn has 	 fav team: Red Sox 	 RedSox friends: 65 	 Cardinals friends: 31
Jagger has 	 fav team: Red Sox 	 RedSox friends: 49 	 Cardinals friends: 28
Jaida has 	 fav team: Red Sox 	 RedSox friends: 46 	 Cardinals friends: 25
Jaiden has 	 fav team: Cardinals 	 RedSox friends: 24 	 Cardinals friends: 40
Jaidyn has 	 fav team: Cardinals 	 RedSox friends: 27 	 Cardinals friends: 57
Jaime has 	 fav team: Cardinals 	 RedSox friends: 32 	 Cardinals friends: 50
Jairo has 	 fav team: Red Sox 	 RedSox friends: 45 	 Cardinals friends: 25
Jakayla has 	 fav team: Red Sox 	 RedSox friends: 56 	 Cardinals friends: 21
Jake has 	 fav team: Red Sox 	 RedSox friends: 57 	 Cardinals friends: 30
Jakob has 	 fav team: Red Sox 	 RedSox friends: 41 	 Cardinals friends: 16
Jalen has 	 fav team: Cardinals 	 RedSox friends: 29 	 Cardinals friends: 49
Jaliyah has 	 fav team: Red Sox 	 RedSox friends: 49 	 Cardinals friends: 27
Jamal has 	 fav team: Red Sox 	 RedSox friends: 44 	 Cardinals friends: 28
Jamar has 	 fav team: Red Sox 	 RedSox friends: 45 	 Cardinals friends: 35
Jamari has 	 fav team: Red Sox 	 RedSox friends: 48 	 Cardinals friends: 18
Jamarion has 	 fav team: Cardinals 	 RedSox friends: 34 	 Cardinals friends: 56
James has 	 fav team: Red Sox 	 RedSox friends: 40 	 Cardinals friends: 28
Jameson has 	 fav team: Red Sox 	 RedSox friends: 56 	 Cardinals friends: 30
Jamie has 	 fav team: Cardinals 	 RedSox friends: 29 	 Cardinals friends: 45
Jamir has 	 fav team: Red Sox 	 RedSox friends: 46 	 Cardinals friends: 33
Jamison has 	 fav team: Cardinals 	 RedSox friends: 23 	 Cardinals friends: 51
Janae has 	 fav team: Cardinals 	 RedSox friends: 36 	 Cardinals friends: 53
Jane has 	 fav team: Red Sox 	 RedSox friends: 53 	 Cardinals friends: 28
Janelle has 	 fav team: Red Sox 	 RedSox friends: 42 	 Cardinals friends: 37
Janessa has 	 fav team: Cardinals 	 RedSox friends: 34 	 Cardinals friends: 31
Janiya has 	 fav team: Cardinals 	 RedSox friends: 28 	 Cardinals friends: 48
Janiyah has 	 fav team: Red Sox 	 RedSox friends: 48 	 Cardinals friends: 31
Jaqueline has 	 fav team: Cardinals 	 RedSox friends: 26 	 Cardinals friends: 50
Jared has 	 fav team: Red Sox 	 RedSox friends: 51 	 Cardinals friends: 27
Jarrett has 	 fav team: Cardinals 	 RedSox friends: 29 	 Cardinals friends: 51
Jase has 	 fav team: Red Sox 	 RedSox friends: 51 	 Cardinals friends: 31
Jasiah has 	 fav team: Red Sox 	 RedSox friends: 62 	 Cardinals friends: 25
Jasmin has 	 fav team: Cardinals 	 RedSox friends: 34 	 Cardinals friends: 52
Jasmine has 	 fav team: Red Sox 	 RedSox friends: 54 	 Cardinals friends: 29
Jason has 	 fav team: Red Sox 	 RedSox friends: 58 	 Cardinals friends: 23
Jasper has 	 fav team: Red Sox 	 RedSox friends: 54 	 Cardinals friends: 33
Javier has 	 fav team: Red Sox 	 RedSox friends: 57 	 Cardinals friends: 29
Javion has 	 fav team: Red Sox 	 RedSox friends: 51 	 Cardinals friends: 30
Javon has 	 fav team: Cardinals 	 RedSox friends: 36 	 Cardinals friends: 51
Jax has 	 fav team: Red Sox 	 RedSox friends: 45 	 Cardinals friends: 24
Jaxen has 	 fav team: Cardinals 	 RedSox friends: 30 	 Cardinals friends: 42
Jaxon has 	 fav team: Red Sox 	 RedSox friends: 42 	 Cardinals friends: 31
Jaxson has 	 fav team: Red Sox 	 RedSox friends: 49 	 Cardinals friends: 26
Jaxton has 	 fav team: Red Sox 	 RedSox friends: 55 	 Cardinals friends: 25
Jay has 	 fav team: Cardinals 	 RedSox friends: 23 	 Cardinals friends: 56
Jayce has 	 fav team: Cardinals 	 RedSox friends: 25 	 Cardinals friends: 42
Jaycee has 	 fav team: Cardinals 	 RedSox friends: 34 	 Cardinals friends: 60
Jaycob has 	 fav team: Cardinals 	 RedSox friends: 31 	 Cardinals friends: 62
Jayda has 	 fav team: Red Sox 	 RedSox friends: 45 	 Cardinals friends: 29
Jayde has 	 fav team: Cardinals 	 RedSox friends: 24 	 Cardinals friends: 44
Jayden has 	 fav team: Cardinals 	 RedSox friends: 23 	 Cardinals friends: 42
Jaydon has 	 fav team: Red Sox 	 RedSox friends: 40 	 Cardinals friends: 25
Jayla has 	 fav team: Red Sox 	 RedSox friends: 42 	 Cardinals friends: 30
Jaylah has 	 fav team: Cardinals 	 RedSox friends: 29 	 Cardinals friends: 53
Jaylee has 	 fav team: Cardinals 	 RedSox friends: 35 	 Cardinals friends: 58
Jayleen has 	 fav team: Cardinals 	 RedSox friends: 23 	 Cardinals friends: 36
Jaylen has 	 fav team: Cardinals 	 RedSox friends: 21 	 Cardinals friends: 46
Jaylene has 	 fav team: Red Sox 	 RedSox friends: 49 	 Cardinals friends: 33
Jaylin has 	 fav team: Red Sox 	 RedSox friends: 45 	 Cardinals friends: 22
Jaylon has 	 fav team: Red Sox 	 RedSox friends: 59 	 Cardinals friends: 25
Jaylynn has 	 fav team: Cardinals 	 RedSox friends: 30 	 Cardinals friends: 39
Jayson has 	 fav team: Cardinals 	 RedSox friends: 26 	 Cardinals friends: 60
Jazlyn has 	 fav team: Cardinals 	 RedSox friends: 29 	 Cardinals friends: 55
Jazlynn has 	 fav team: Cardinals 	 RedSox friends: 28 	 Cardinals friends: 53
Jazmin has 	 fav team: Red Sox 	 RedSox friends: 41 	 Cardinals friends: 25
Jazmine has 	 fav team: Cardinals 	 RedSox friends: 32 	 Cardinals friends: 40
Jazzlyn has 	 fav team: Cardinals 	 RedSox friends: 19 	 Cardinals friends: 44
Jedidiah has 	 fav team: Cardinals 	 RedSox friends: 35 	 Cardinals friends: 39
Jefferson has 	 fav team: Red Sox 	 RedSox friends: 57 	 Cardinals friends: 23
Jeffery has 	 fav team: Red Sox 	 RedSox friends: 55 	 Cardinals friends: 25
Jeffrey has 	 fav team: Red Sox 	 RedSox friends: 41 	 Cardinals friends: 26
Jemma has 	 fav team: Red Sox 	 RedSox friends: 53 	 Cardinals friends: 26
Jenna has 	 fav team: Red Sox 	 RedSox friends: 53 	 Cardinals friends: 28
Jennifer has 	 fav team: Red Sox 	 RedSox friends: 39 	 Cardinals friends: 25
Jenny has 	 fav team: Red Sox 	 RedSox friends: 55 	 Cardinals friends: 30
Jensen has 	 fav team: Cardinals 	 RedSox friends: 19 	 Cardinals friends: 51
Jeremiah has 	 fav team: Red Sox 	 RedSox friends: 45 	 Cardinals friends: 30
Jeremy has 	 fav team: Red Sox 	 RedSox friends: 44 	 Cardinals friends: 25
Jermaine has 	 fav team: Cardinals 	 RedSox friends: 29 	 Cardinals friends: 58
Jerome has 	 fav team: Red Sox 	 RedSox friends: 55 	 Cardinals friends: 27
Jerry has 	 fav team: Red Sox 	 RedSox friends: 51 	 Cardinals friends: 30
Jessa has 	 fav team: Red Sox 	 RedSox friends: 52 	 Cardinals friends: 23
Jesse has 	 fav team: Cardinals 	 RedSox friends: 35 	 Cardinals friends: 62
Jessica has 	 fav team: Cardinals 	 RedSox friends: 41 	 Cardinals friends: 44
Jessie has 	 fav team: Cardinals 	 RedSox friends: 20 	 Cardinals friends: 45
Jesus has 	 fav team: Red Sox 	 RedSox friends: 50 	 Cardinals friends: 31
Jett has 	 fav team: Cardinals 	 RedSox friends: 34 	 Cardinals friends: 40
Jewel has 	 fav team: Red Sox 	 RedSox friends: 47 	 Cardinals friends: 32
Jillian has 	 fav team: Red Sox 	 RedSox friends: 49 	 Cardinals friends: 20
Jimena has 	 fav team: Cardinals 	 RedSox friends: 28 	 Cardinals friends: 45
Jimmy has 	 fav team: Red Sox 	 RedSox friends: 56 	 Cardinals friends: 34
Jionni has 	 fav team: Red Sox 	 RedSox friends: 52 	 Cardinals friends: 32
Joanna has 	 fav team: Cardinals 	 RedSox friends: 19 	 Cardinals friends: 46
Joaquin has 	 fav team: Cardinals 	 RedSox friends: 31 	 Cardinals friends: 45
Jocelyn has 	 fav team: Red Sox 	 RedSox friends: 53 	 Cardinals friends: 33
Jocelynn has 	 fav team: Cardinals 	 RedSox friends: 23 	 Cardinals friends: 46
Joe has 	 fav team: Cardinals 	 RedSox friends: 29 	 Cardinals friends: 54
Joel has 	 fav team: Red Sox 	 RedSox friends: 59 	 Cardinals friends: 35
Joey has 	 fav team: Cardinals 	 RedSox friends: 29 	 Cardinals friends: 49
Johan has 	 fav team: Cardinals 	 RedSox friends: 34 	 Cardinals friends: 57
Johann has 	 fav team: Red Sox 	 RedSox friends: 42 	 Cardinals friends: 27
Johanna has 	 fav team: Red Sox 	 RedSox friends: 56 	 Cardinals friends: 26
John has 	 fav team: Cardinals 	 RedSox friends: 40 	 Cardinals friends: 49
Johnathan has 	 fav team: Red Sox 	 RedSox friends: 51 	 Cardinals friends: 21
Johnathon has 	 fav team: Cardinals 	 RedSox friends: 34 	 Cardinals friends: 40
Johnny has 	 fav team: Cardinals 	 RedSox friends: 30 	 Cardinals friends: 45
Jolene has 	 fav team: Red Sox 	 RedSox friends: 60 	 Cardinals friends: 29
Jolie has 	 fav team: Cardinals 	 RedSox friends: 34 	 Cardinals friends: 54
Jon has 	 fav team: Cardinals 	 RedSox friends: 30 	 Cardinals friends: 52
Jonah has 	 fav team: Cardinals 	 RedSox friends: 30 	 Cardinals friends: 53
Jonas has 	 fav team: Cardinals 	 RedSox friends: 36 	 Cardinals friends: 38
Jonathan has 	 fav team: Cardinals 	 RedSox friends: 31 	 Cardinals friends: 44
Jonathon has 	 fav team: Cardinals 	 RedSox friends: 35 	 Cardinals friends: 47
Jordan has 	 fav team: Cardinals 	 RedSox friends: 25 	 Cardinals friends: 38
Jorden has 	 fav team: Red Sox 	 RedSox friends: 63 	 Cardinals friends: 37
Jordyn has 	 fav team: Cardinals 	 RedSox friends: 31 	 Cardinals friends: 54
Jordynn has 	 fav team: Cardinals 	 RedSox friends: 32 	 Cardinals friends: 39
Jorge has 	 fav team: Red Sox 	 RedSox friends: 53 	 Cardinals friends: 28
Jose has 	 fav team: Red Sox 	 RedSox friends: 40 	 Cardinals friends: 24
Joselyn has 	 fav team: Red Sox 	 RedSox friends: 38 	 Cardinals friends: 32
Joseph has 	 fav team: Cardinals 	 RedSox friends: 28 	 Cardinals friends: 46
Josephine has 	 fav team: Cardinals 	 RedSox friends: 31 	 Cardinals friends: 51
Joshua has 	 fav team: Cardinals 	 RedSox friends: 37 	 Cardinals friends: 46
Josiah has 	 fav team: Cardinals 	 RedSox friends: 31 	 Cardinals friends: 55
Josie has 	 fav team: Cardinals 	 RedSox friends: 30 	 Cardinals friends: 40
Joslyn has 	 fav team: Red Sox 	 RedSox friends: 44 	 Cardinals friends: 28
Josue has 	 fav team: Cardinals 	 RedSox friends: 36 	 Cardinals friends: 56
Journee has 	 fav team: Cardinals 	 RedSox friends: 34 	 Cardinals friends: 43
Journey has 	 fav team: Red Sox 	 RedSox friends: 64 	 Cardinals friends: 30
Jovani has 	 fav team: Cardinals 	 RedSox friends: 28 	 Cardinals friends: 46
Jovanni has 	 fav team: Cardinals 	 RedSox friends: 29 	 Cardinals friends: 52
Joy has 	 fav team: Red Sox 	 RedSox friends: 43 	 Cardinals friends: 32
Joyce has 	 fav team: Cardinals 	 RedSox friends: 21 	 Cardinals friends: 55
Joziah has 	 fav team: Red Sox 	 RedSox friends: 41 	 Cardinals friends: 25
Juan has 	 fav team: Cardinals 	 RedSox friends: 28 	 Cardinals friends: 44
Judah has 	 fav team: Cardinals 	 RedSox friends: 18 	 Cardinals friends: 57
Jude has 	 fav team: Red Sox 	 RedSox friends: 49 	 Cardinals friends: 24
Judith has 	 fav team: Red Sox 	 RedSox friends: 49 	 Cardinals friends: 27
Juelz has 	 fav team: Cardinals 	 RedSox friends: 27 	 Cardinals friends: 46
Julia has 	 fav team: Cardinals 	 RedSox friends: 29 	 Cardinals friends: 45
Julian has 	 fav team: Red Sox 	 RedSox friends: 55 	 Cardinals friends: 32
Juliana has 	 fav team: Red Sox 	 RedSox friends: 54 	 Cardinals friends: 30
Julianna has 	 fav team: Cardinals 	 RedSox friends: 25 	 Cardinals friends: 51
Julianne has 	 fav team: Red Sox 	 RedSox friends: 46 	 Cardinals friends: 34
Julie has 	 fav team: Red Sox 	 RedSox friends: 51 	 Cardinals friends: 32
Julien has 	 fav team: Red Sox 	 RedSox friends: 50 	 Cardinals friends: 34
Juliet has 	 fav team: Red Sox 	 RedSox friends: 51 	 Cardinals friends: 27
Juliette has 	 fav team: Red Sox 	 RedSox friends: 56 	 Cardinals friends: 28
Julio has 	 fav team: Cardinals 	 RedSox friends: 32 	 Cardinals friends: 53
Julissa has 	 fav team: Cardinals 	 RedSox friends: 24 	 Cardinals friends: 55
Julius has 	 fav team: Red Sox 	 RedSox friends: 62 	 Cardinals friends: 31
June has 	 fav team: Red Sox 	 RedSox friends: 46 	 Cardinals friends: 17
Junior has 	 fav team: Cardinals 	 RedSox friends: 32 	 Cardinals friends: 37
Juniper has 	 fav team: Red Sox 	 RedSox friends: 37 	 Cardinals friends: 25
Justice has 	 fav team: Red Sox 	 RedSox friends: 51 	 Cardinals friends: 28
Justin has 	 fav team: Red Sox 	 RedSox friends: 45 	 Cardinals friends: 26
Justus has 	 fav team: Cardinals 	 RedSox friends: 19 	 Cardinals friends: 58
Kade has 	 fav team: Cardinals 	 RedSox friends: 26 	 Cardinals friends: 47
Kaden has 	 fav team: Cardinals 	 RedSox friends: 29 	 Cardinals friends: 50
Kadence has 	 fav team: Cardinals 	 RedSox friends: 28 	 Cardinals friends: 46
Kaeden has 	 fav team: Cardinals 	 RedSox friends: 40 	 Cardinals friends: 51
Kael has 	 fav team: Cardinals 	 RedSox friends: 23 	 Cardinals friends: 51
Kaelyn has 	 fav team: Cardinals 	 RedSox friends: 30 	 Cardinals friends: 41
Kaelynn has 	 fav team: Red Sox 	 RedSox friends: 37 	 Cardinals friends: 25
Kai has 	 fav team: Cardinals 	 RedSox friends: 30 	 Cardinals friends: 59
Kaia has 	 fav team: Red Sox 	 RedSox friends: 59 	 Cardinals friends: 32
Kaiden has 	 fav team: Cardinals 	 RedSox friends: 28 	 Cardinals friends: 52
Kailee has 	 fav team: Red Sox 	 RedSox friends: 48 	 Cardinals friends: 25
Kailey has 	 fav team: Red Sox 	 RedSox friends: 48 	 Cardinals friends: 24
Kailyn has 	 fav team: Cardinals 	 RedSox friends: 33 	 Cardinals friends: 56
Kailynn has 	 fav team: Red Sox 	 RedSox friends: 46 	 Cardinals friends: 24
Kairi has 	 fav team: Cardinals 	 RedSox friends: 33 	 Cardinals friends: 46
Kaitlin has 	 fav team: Cardinals 	 RedSox friends: 23 	 Cardinals friends: 49
Kaitlyn has 	 fav team: Cardinals 	 RedSox friends: 31 	 Cardinals friends: 50
Kaitlynn has 	 fav team: Red Sox 	 RedSox friends: 57 	 Cardinals friends: 29
Kaiya has 	 fav team: Red Sox 	 RedSox friends: 54 	 Cardinals friends: 24
Kale has 	 fav team: Red Sox 	 RedSox friends: 60 	 Cardinals friends: 30
Kaleb has 	 fav team: Red Sox 	 RedSox friends: 48 	 Cardinals friends: 20
Kaleigh has 	 fav team: Red Sox 	 RedSox friends: 46 	 Cardinals friends: 29
Kali has 	 fav team: Red Sox 	 RedSox friends: 50 	 Cardinals friends: 36
Kaliyah has 	 fav team: Cardinals 	 RedSox friends: 28 	 Cardinals friends: 49
Kallie has 	 fav team: Red Sox 	 RedSox friends: 52 	 Cardinals friends: 33
Kamari has 	 fav team: Cardinals 	 RedSox friends: 33 	 Cardinals friends: 56
Kamden has 	 fav team: Red Sox 	 RedSox friends: 54 	 Cardinals friends: 29
Kameron has 	 fav team: Cardinals 	 RedSox friends: 34 	 Cardinals friends: 53
Kamila has 	 fav team: Red Sox 	 RedSox friends: 47 	 Cardinals friends: 33
Kamron has 	 fav team: Cardinals 	 RedSox friends: 32 	 Cardinals friends: 42
Kamryn has 	 fav team: Red Sox 	 RedSox friends: 44 	 Cardinals friends: 22
Kane has 	 fav team: Red Sox 	 RedSox friends: 54 	 Cardinals friends: 39
Kara has 	 fav team: Cardinals 	 RedSox friends: 29 	 Cardinals friends: 49
Kareem has 	 fav team: Red Sox 	 RedSox friends: 59 	 Cardinals friends: 32
Karen has 	 fav team: Cardinals 	 RedSox friends: 34 	 Cardinals friends: 49
Karina has 	 fav team: Red Sox 	 RedSox friends: 53 	 Cardinals friends: 21
Karis has 	 fav team: Red Sox 	 RedSox friends: 34 	 Cardinals friends: 21
Karissa has 	 fav team: Red Sox 	 RedSox friends: 53 	 Cardinals friends: 42
Karla has 	 fav team: Cardinals 	 RedSox friends: 40 	 Cardinals friends: 52
Karlee has 	 fav team: Cardinals 	 RedSox friends: 26 	 Cardinals friends: 47
Karlie has 	 fav team: Cardinals 	 RedSox friends: 34 	 Cardinals friends: 49
Karma has 	 fav team: Red Sox 	 RedSox friends: 44 	 Cardinals friends: 26
Karsen has 	 fav team: Cardinals 	 RedSox friends: 31 	 Cardinals friends: 42
Karson has 	 fav team: Red Sox 	 RedSox friends: 45 	 Cardinals friends: 31
Karsyn has 	 fav team: Cardinals 	 RedSox friends: 31 	 Cardinals friends: 41
Karter has 	 fav team: Red Sox 	 RedSox friends: 54 	 Cardinals friends: 38
Kase has 	 fav team: Red Sox 	 RedSox friends: 51 	 Cardinals friends: 34
Kasen has 	 fav team: Red Sox 	 RedSox friends: 49 	 Cardinals friends: 23
Kasey has 	 fav team: Cardinals 	 RedSox friends: 33 	 Cardinals friends: 49
Kash has 	 fav team: Cardinals 	 RedSox friends: 36 	 Cardinals friends: 46
Kason has 	 fav team: Red Sox 	 RedSox friends: 62 	 Cardinals friends: 25
Kassandra has 	 fav team: Cardinals 	 RedSox friends: 30 	 Cardinals friends: 50
Kassidy has 	 fav team: Red Sox 	 RedSox friends: 48 	 Cardinals friends: 33
Katalina has 	 fav team: Red Sox 	 RedSox friends: 62 	 Cardinals friends: 35
Kate has 	 fav team: Red Sox 	 RedSox friends: 57 	 Cardinals friends: 23
Katelyn has 	 fav team: Cardinals 	 RedSox friends: 25 	 Cardinals friends: 50
Katelynn has 	 fav team: Red Sox 	 RedSox friends: 56 	 Cardinals friends: 24
Katherine has 	 fav team: Cardinals 	 RedSox friends: 28 	 Cardinals friends: 41
Kathleen has 	 fav team: Cardinals 	 RedSox friends: 20 	 Cardinals friends: 39
Kathryn has 	 fav team: Red Sox 	 RedSox friends: 53 	 Cardinals friends: 23
Katie has 	 fav team: Red Sox 	 RedSox friends: 44 	 Cardinals friends: 30
Katrina has 	 fav team: Red Sox 	 RedSox friends: 40 	 Cardinals friends: 32
Kaya has 	 fav team: Cardinals 	 RedSox friends: 28 	 Cardinals friends: 48
Kayden has 	 fav team: Cardinals 	 RedSox friends: 42 	 Cardinals friends: 40
Kaydence has 	 fav team: Cardinals 	 RedSox friends: 29 	 Cardinals friends: 42
Kayla has 	 fav team: Red Sox 	 RedSox friends: 61 	 Cardinals friends: 31
Kaylee has 	 fav team: Red Sox 	 RedSox friends: 46 	 Cardinals friends: 40
Kayleigh has 	 fav team: Cardinals 	 RedSox friends: 31 	 Cardinals friends: 41
Kaylen has 	 fav team: Cardinals 	 RedSox friends: 30 	 Cardinals friends: 44
Kaylie has 	 fav team: Cardinals 	 RedSox friends: 25 	 Cardinals friends: 57
Kaylin has 	 fav team: Red Sox 	 RedSox friends: 57 	 Cardinals friends: 36
Kaylyn has 	 fav team: Cardinals 	 RedSox friends: 36 	 Cardinals friends: 50
Kaylynn has 	 fav team: Cardinals 	 RedSox friends: 37 	 Cardinals friends: 56
Kaysen has 	 fav team: Cardinals 	 RedSox friends: 30 	 Cardinals friends: 44
Kayson has 	 fav team: Cardinals 	 RedSox friends: 28 	 Cardinals friends: 47
Keagan has 	 fav team: Red Sox 	 RedSox friends: 60 	 Cardinals friends: 29
Keaton has 	 fav team: Red Sox 	 RedSox friends: 54 	 Cardinals friends: 38
Keegan has 	 fav team: Cardinals 	 RedSox friends: 31 	 Cardinals friends: 52
Keenan has 	 fav team: Cardinals 	 RedSox friends: 29 	 Cardinals friends: 51
Keira has 	 fav team: Red Sox 	 RedSox friends: 62 	 Cardinals friends: 28
Keith has 	 fav team: Red Sox 	 RedSox friends: 46 	 Cardinals friends: 32
Kellan has 	 fav team: Red Sox 	 RedSox friends: 50 	 Cardinals friends: 29
Kellen has 	 fav team: Cardinals 	 RedSox friends: 28 	 Cardinals friends: 62
Kelly has 	 fav team: Cardinals 	 RedSox friends: 34 	 Cardinals friends: 39
Kelsey has 	 fav team: Red Sox 	 RedSox friends: 55 	 Cardinals friends: 37
Kelvin has 	 fav team: Cardinals 	 RedSox friends: 33 	 Cardinals friends: 60
Kendal has 	 fav team: Cardinals 	 RedSox friends: 28 	 Cardinals friends: 42
Kendall has 	 fav team: Red Sox 	 RedSox friends: 53 	 Cardinals friends: 35
Kendra has 	 fav team: Red Sox 	 RedSox friends: 47 	 Cardinals friends: 30
Kendrick has 	 fav team: Cardinals 	 RedSox friends: 45 	 Cardinals friends: 48
Kendyl has 	 fav team: Cardinals 	 RedSox friends: 31 	 Cardinals friends: 49
Kenia has 	 fav team: Cardinals 	 RedSox friends: 36 	 Cardinals friends: 52
Kenley has 	 fav team: Cardinals 	 RedSox friends: 25 	 Cardinals friends: 45
Kenna has 	 fav team: Cardinals 	 RedSox friends: 23 	 Cardinals friends: 50
Kennedi has 	 fav team: Red Sox 	 RedSox friends: 54 	 Cardinals friends: 22
Kennedy has 	 fav team: Cardinals 	 RedSox friends: 35 	 Cardinals friends: 59
Kenneth has 	 fav team: Red Sox 	 RedSox friends: 59 	 Cardinals friends: 24
Kenny has 	 fav team: Red Sox 	 RedSox friends: 50 	 Cardinals friends: 22
Kensley has 	 fav team: Red Sox 	 RedSox friends: 58 	 Cardinals friends: 30
Kenya has 	 fav team: Red Sox 	 RedSox friends: 63 	 Cardinals friends: 32
Kenzie has 	 fav team: Cardinals 	 RedSox friends: 21 	 Cardinals friends: 58
Kevin has 	 fav team: Cardinals 	 RedSox friends: 30 	 Cardinals friends: 47
Keyla has 	 fav team: Cardinals 	 RedSox friends: 31 	 Cardinals friends: 45
Khalil has 	 fav team: Cardinals 	 RedSox friends: 26 	 Cardinals friends: 50
Khloe has 	 fav team: Red Sox 	 RedSox friends: 53 	 Cardinals friends: 28
Kian has 	 fav team: Cardinals 	 RedSox friends: 40 	 Cardinals friends: 51
Kiana has 	 fav team: Cardinals 	 RedSox friends: 27 	 Cardinals friends: 45
Kiara has 	 fav team: Cardinals 	 RedSox friends: 23 	 Cardinals friends: 58
Kiera has 	 fav team: Red Sox 	 RedSox friends: 55 	 Cardinals friends: 22
Kieran has 	 fav team: Red Sox 	 RedSox friends: 53 	 Cardinals friends: 31
Kiley has 	 fav team: Red Sox 	 RedSox friends: 37 	 Cardinals friends: 27
Killian has 	 fav team: Red Sox 	 RedSox friends: 51 	 Cardinals friends: 26
Kimber has 	 fav team: Red Sox 	 RedSox friends: 46 	 Cardinals friends: 28
Kimberly has 	 fav team: Red Sox 	 RedSox friends: 54 	 Cardinals friends: 32
Kimora has 	 fav team: Red Sox 	 RedSox friends: 36 	 Cardinals friends: 33
King has 	 fav team: Red Sox 	 RedSox friends: 48 	 Cardinals friends: 29
Kingsley has 	 fav team: Red Sox 	 RedSox friends: 41 	 Cardinals friends: 22
Kingston has 	 fav team: Cardinals 	 RedSox friends: 33 	 Cardinals friends: 43
Kinley has 	 fav team: Red Sox 	 RedSox friends: 54 	 Cardinals friends: 34
Kinsley has 	 fav team: Red Sox 	 RedSox friends: 52 	 Cardinals friends: 27
Kira has 	 fav team: Cardinals 	 RedSox friends: 35 	 Cardinals friends: 38
Kirsten has 	 fav team: Red Sox 	 RedSox friends: 50 	 Cardinals friends: 24
Knox has 	 fav team: Red Sox 	 RedSox friends: 38 	 Cardinals friends: 26
Kobe has 	 fav team: Red Sox 	 RedSox friends: 51 	 Cardinals friends: 18
Kody has 	 fav team: Cardinals 	 RedSox friends: 26 	 Cardinals friends: 45
Kohen has 	 fav team: Cardinals 	 RedSox friends: 30 	 Cardinals friends: 47
Kolby has 	 fav team: Cardinals 	 RedSox friends: 34 	 Cardinals friends: 43
Kole has 	 fav team: Red Sox 	 RedSox friends: 51 	 Cardinals friends: 28
Kolten has 	 fav team: Cardinals 	 RedSox friends: 37 	 Cardinals friends: 43
Kolton has 	 fav team: Red Sox 	 RedSox friends: 60 	 Cardinals friends: 37
Konner has 	 fav team: Red Sox 	 RedSox friends: 39 	 Cardinals friends: 21
Konnor has 	 fav team: Cardinals 	 RedSox friends: 26 	 Cardinals friends: 46
Kora has 	 fav team: Red Sox 	 RedSox friends: 49 	 Cardinals friends: 32
Korbin has 	 fav team: Red Sox 	 RedSox friends: 49 	 Cardinals friends: 32
Kourtney has 	 fav team: Red Sox 	 RedSox friends: 39 	 Cardinals friends: 24
Krish has 	 fav team: Cardinals 	 RedSox friends: 35 	 Cardinals friends: 39
Kristen has 	 fav team: Red Sox 	 RedSox friends: 45 	 Cardinals friends: 27
Kristian has 	 fav team: Red Sox 	 RedSox friends: 58 	 Cardinals friends: 30
Kristina has 	 fav team: Red Sox 	 RedSox friends: 45 	 Cardinals friends: 28
Kristopher has 	 fav team: Cardinals 	 RedSox friends: 25 	 Cardinals friends: 52
Krystal has 	 fav team: Red Sox 	 RedSox friends: 57 	 Cardinals friends: 33
Kyla has 	 fav team: Red Sox 	 RedSox friends: 52 	 Cardinals friends: 30
Kylah has 	 fav team: Red Sox 	 RedSox friends: 50 	 Cardinals friends: 26
Kylan has 	 fav team: Red Sox 	 RedSox friends: 37 	 Cardinals friends: 33
Kyle has 	 fav team: Red Sox 	 RedSox friends: 41 	 Cardinals friends: 37
Kylee has 	 fav team: Cardinals 	 RedSox friends: 34 	 Cardinals friends: 52
Kyleigh has 	 fav team: Cardinals 	 RedSox friends: 30 	 Cardinals friends: 55
Kylen has 	 fav team: Cardinals 	 RedSox friends: 25 	 Cardinals friends: 42
Kyler has 	 fav team: Cardinals 	 RedSox friends: 29 	 Cardinals friends: 48
Kylie has 	 fav team: Cardinals 	 RedSox friends: 39 	 Cardinals friends: 56
Kymani has 	 fav team: Cardinals 	 RedSox friends: 26 	 Cardinals friends: 60
Kyndal has 	 fav team: Red Sox 	 RedSox friends: 41 	 Cardinals friends: 30
Kyndall has 	 fav team: Red Sox 	 RedSox friends: 38 	 Cardinals friends: 30
Kynlee has 	 fav team: Red Sox 	 RedSox friends: 43 	 Cardinals friends: 28
Kyra has 	 fav team: Cardinals 	 RedSox friends: 35 	 Cardinals friends: 52
Kyree has 	 fav team: Red Sox 	 RedSox friends: 54 	 Cardinals friends: 31
Kyrie has 	 fav team: Red Sox 	 RedSox friends: 46 	 Cardinals friends: 31
Kyson has 	 fav team: Cardinals 	 RedSox friends: 19 	 Cardinals friends: 38
Lacey has 	 fav team: Cardinals 	 RedSox friends: 18 	 Cardinals friends: 49
Laila has 	 fav team: Cardinals 	 RedSox friends: 34 	 Cardinals friends: 52
Lailah has 	 fav team: Cardinals 	 RedSox friends: 33 	 Cardinals friends: 47
Lainey has 	 fav team: Red Sox 	 RedSox friends: 50 	 Cardinals friends: 44
Lamar has 	 fav team: Cardinals 	 RedSox friends: 23 	 Cardinals friends: 46
Lana has 	 fav team: Cardinals 	 RedSox friends: 23 	 Cardinals friends: 41
Lance has 	 fav team: Red Sox 	 RedSox friends: 50 	 Cardinals friends: 37
Landen has 	 fav team: Red Sox 	 RedSox friends: 54 	 Cardinals friends: 29
Landon has 	 fav team: Cardinals 	 RedSox friends: 23 	 Cardinals friends: 47
Landry has 	 fav team: Red Sox 	 RedSox friends: 56 	 Cardinals friends: 32
Landyn has 	 fav team: Cardinals 	 RedSox friends: 27 	 Cardinals friends: 49
Lane has 	 fav team: Cardinals 	 RedSox friends: 19 	 Cardinals friends: 47
Laney has 	 fav team: Cardinals 	 RedSox friends: 28 	 Cardinals friends: 62
Lara has 	 fav team: Red Sox 	 RedSox friends: 49 	 Cardinals friends: 29
Larissa has 	 fav team: Red Sox 	 RedSox friends: 51 	 Cardinals friends: 27
Larry has 	 fav team: Cardinals 	 RedSox friends: 27 	 Cardinals friends: 57
Laura has 	 fav team: Red Sox 	 RedSox friends: 57 	 Cardinals friends: 40
Laurel has 	 fav team: Cardinals 	 RedSox friends: 20 	 Cardinals friends: 40
Lauren has 	 fav team: Cardinals 	 RedSox friends: 18 	 Cardinals friends: 50
Lauryn has 	 fav team: Red Sox 	 RedSox friends: 52 	 Cardinals friends: 32
Lawrence has 	 fav team: Red Sox 	 RedSox friends: 37 	 Cardinals friends: 40
Lawson has 	 fav team: Red Sox 	 RedSox friends: 63 	 Cardinals friends: 26
Layla has 	 fav team: Cardinals 	 RedSox friends: 37 	 Cardinals friends: 47
Laylah has 	 fav team: Red Sox 	 RedSox friends: 60 	 Cardinals friends: 26
Layne has 	 fav team: Red Sox 	 RedSox friends: 64 	 Cardinals friends: 30
Layton has 	 fav team: Red Sox 	 RedSox friends: 52 	 Cardinals friends: 24
Lea has 	 fav team: Red Sox 	 RedSox friends: 62 	 Cardinals friends: 28
Leah has 	 fav team: Cardinals 	 RedSox friends: 21 	 Cardinals friends: 34
Leandro has 	 fav team: Cardinals 	 RedSox friends: 31 	 Cardinals friends: 56
Leanna has 	 fav team: Cardinals 	 RedSox friends: 40 	 Cardinals friends: 56
Lee has 	 fav team: Cardinals 	 RedSox friends: 28 	 Cardinals friends: 42
Legend has 	 fav team: Red Sox 	 RedSox friends: 37 	 Cardinals friends: 33
Leia has 	 fav team: Red Sox 	 RedSox friends: 50 	 Cardinals friends: 31
Leighton has 	 fav team: Cardinals 	 RedSox friends: 29 	 Cardinals friends: 50
Leila has 	 fav team: Red Sox 	 RedSox friends: 46 	 Cardinals friends: 32
Leilani has 	 fav team: Cardinals 	 RedSox friends: 34 	 Cardinals friends: 52
Leland has 	 fav team: Red Sox 	 RedSox friends: 51 	 Cardinals friends: 21
Lena has 	 fav team: Cardinals 	 RedSox friends: 20 	 Cardinals friends: 49
Lennon has 	 fav team: Red Sox 	 RedSox friends: 45 	 Cardinals friends: 29
Lennox has 	 fav team: Cardinals 	 RedSox friends: 21 	 Cardinals friends: 49
Leo has 	 fav team: Cardinals 	 RedSox friends: 32 	 Cardinals friends: 32
Leon has 	 fav team: Red Sox 	 RedSox friends: 50 	 Cardinals friends: 28
Leona has 	 fav team: Cardinals 	 RedSox friends: 36 	 Cardinals friends: 46
Leonard has 	 fav team: Cardinals 	 RedSox friends: 32 	 Cardinals friends: 49
Leonardo has 	 fav team: Cardinals 	 RedSox friends: 29 	 Cardinals friends: 55
Leonel has 	 fav team: Cardinals 	 RedSox friends: 26 	 Cardinals friends: 36
Leonidas has 	 fav team: Cardinals 	 RedSox friends: 33 	 Cardinals friends: 54
Leroy has 	 fav team: Red Sox 	 RedSox friends: 57 	 Cardinals friends: 31
Leslie has 	 fav team: Cardinals 	 RedSox friends: 30 	 Cardinals friends: 45
Lesly has 	 fav team: Red Sox 	 RedSox friends: 40 	 Cardinals friends: 37
Levi has 	 fav team: Red Sox 	 RedSox friends: 61 	 Cardinals friends: 31
Lewis has 	 fav team: Red Sox 	 RedSox friends: 45 	 Cardinals friends: 36
Lexi has 	 fav team: Cardinals 	 RedSox friends: 23 	 Cardinals friends: 42
Lexie has 	 fav team: Red Sox 	 RedSox friends: 44 	 Cardinals friends: 27
Leyla has 	 fav team: Cardinals 	 RedSox friends: 26 	 Cardinals friends: 42
Lia has 	 fav team: Red Sox 	 RedSox friends: 49 	 Cardinals friends: 29
Liam has 	 fav team: Cardinals 	 RedSox friends: 30 	 Cardinals friends: 44
Liana has 	 fav team: Red Sox 	 RedSox friends: 48 	 Cardinals friends: 34
Libby has 	 fav team: Red Sox 	 RedSox friends: 53 	 Cardinals friends: 28
Liberty has 	 fav team: Cardinals 	 RedSox friends: 21 	 Cardinals friends: 55
Lila has 	 fav team: Cardinals 	 RedSox friends: 31 	 Cardinals friends: 44
Lilah has 	 fav team: Cardinals 	 RedSox friends: 34 	 Cardinals friends: 43
Lilia has 	 fav team: Red Sox 	 RedSox friends: 60 	 Cardinals friends: 36
Lilian has 	 fav team: Red Sox 	 RedSox friends: 43 	 Cardinals friends: 27
Liliana has 	 fav team: Red Sox 	 RedSox friends: 55 	 Cardinals friends: 42
Lilianna has 	 fav team: Red Sox 	 RedSox friends: 56 	 Cardinals friends: 24
Lilith has 	 fav team: Red Sox 	 RedSox friends: 45 	 Cardinals friends: 15
Lillian has 	 fav team: Cardinals 	 RedSox friends: 24 	 Cardinals friends: 51
Lilliana has 	 fav team: Cardinals 	 RedSox friends: 30 	 Cardinals friends: 46
Lillianna has 	 fav team: Cardinals 	 RedSox friends: 33 	 Cardinals friends: 56
Lillie has 	 fav team: Cardinals 	 RedSox friends: 23 	 Cardinals friends: 37
Lilly has 	 fav team: Cardinals 	 RedSox friends: 29 	 Cardinals friends: 45
Lillyana has 	 fav team: Red Sox 	 RedSox friends: 45 	 Cardinals friends: 30
Lily has 	 fav team: Cardinals 	 RedSox friends: 33 	 Cardinals friends: 48
Lilyana has 	 fav team: Red Sox 	 RedSox friends: 44 	 Cardinals friends: 32
Lilyanna has 	 fav team: Cardinals 	 RedSox friends: 30 	 Cardinals friends: 56
Lina has 	 fav team: Red Sox 	 RedSox friends: 46 	 Cardinals friends: 29
Lincoln has 	 fav team: Cardinals 	 RedSox friends: 24 	 Cardinals friends: 48
Linda has 	 fav team: Cardinals 	 RedSox friends: 32 	 Cardinals friends: 48
Lindsay has 	 fav team: Cardinals 	 RedSox friends: 34 	 Cardinals friends: 39
Lindsey has 	 fav team: Cardinals 	 RedSox friends: 36 	 Cardinals friends: 51
Lionel has 	 fav team: Red Sox 	 RedSox friends: 37 	 Cardinals friends: 21
Lisa has 	 fav team: Cardinals 	 RedSox friends: 39 	 Cardinals friends: 44
Litzy has 	 fav team: Cardinals 	 RedSox friends: 35 	 Cardinals friends: 51
Livia has 	 fav team: Red Sox 	 RedSox friends: 52 	 Cardinals friends: 36
Lizbeth has 	 fav team: Cardinals 	 RedSox friends: 24 	 Cardinals friends: 54
Logan has 	 fav team: Red Sox 	 RedSox friends: 50 	 Cardinals friends: 40
Lola has 	 fav team: Cardinals 	 RedSox friends: 35 	 Cardinals friends: 55
London has 	 fav team: Red Sox 	 RedSox friends: 39 	 Cardinals friends: 26
Londyn has 	 fav team: Red Sox 	 RedSox friends: 50 	 Cardinals friends: 33
Lorelai has 	 fav team: Red Sox 	 RedSox friends: 42 	 Cardinals friends: 27
Lorelei has 	 fav team: Red Sox 	 RedSox friends: 48 	 Cardinals friends: 32
Lorenzo has 	 fav team: Red Sox 	 RedSox friends: 42 	 Cardinals friends: 37
Louis has 	 fav team: Red Sox 	 RedSox friends: 51 	 Cardinals friends: 22
Luca has 	 fav team: Red Sox 	 RedSox friends: 42 	 Cardinals friends: 41
Lucas has 	 fav team: Cardinals 	 RedSox friends: 22 	 Cardinals friends: 46
Lucca has 	 fav team: Cardinals 	 RedSox friends: 27 	 Cardinals friends: 49
Lucia has 	 fav team: Red Sox 	 RedSox friends: 43 	 Cardinals friends: 36
Lucian has 	 fav team: Red Sox 	 RedSox friends: 55 	 Cardinals friends: 27
Luciana has 	 fav team: Cardinals 	 RedSox friends: 34 	 Cardinals friends: 41
Luciano has 	 fav team: Red Sox 	 RedSox friends: 48 	 Cardinals friends: 22
Lucille has 	 fav team: Cardinals 	 RedSox friends: 29 	 Cardinals friends: 59
Lucy has 	 fav team: Red Sox 	 RedSox friends: 57 	 Cardinals friends: 23
Luis has 	 fav team: Cardinals 	 RedSox friends: 34 	 Cardinals friends: 43
Luka has 	 fav team: Cardinals 	 RedSox friends: 25 	 Cardinals friends: 45
Lukas has 	 fav team: Red Sox 	 RedSox friends: 53 	 Cardinals friends: 23
Luke has 	 fav team: Red Sox 	 RedSox friends: 48 	 Cardinals friends: 23
Luna has 	 fav team: Red Sox 	 RedSox friends: 41 	 Cardinals friends: 28
Luz has 	 fav team: Cardinals 	 RedSox friends: 26 	 Cardinals friends: 36
Lydia has 	 fav team: Cardinals 	 RedSox friends: 33 	 Cardinals friends: 42
Lyla has 	 fav team: Cardinals 	 RedSox friends: 20 	 Cardinals friends: 52
Lylah has 	 fav team: Red Sox 	 RedSox friends: 51 	 Cardinals friends: 26
Lyric has 	 fav team: Cardinals 	 RedSox friends: 38 	 Cardinals friends: 47
Macey has 	 fav team: Cardinals 	 RedSox friends: 30 	 Cardinals friends: 51
Maci has 	 fav team: Cardinals 	 RedSox friends: 28 	 Cardinals friends: 59
Macie has 	 fav team: Red Sox 	 RedSox friends: 48 	 Cardinals friends: 25
Mack has 	 fav team: Cardinals 	 RedSox friends: 37 	 Cardinals friends: 54
Mackenzie has 	 fav team: Cardinals 	 RedSox friends: 34 	 Cardinals friends: 38
Macy has 	 fav team: Red Sox 	 RedSox friends: 48 	 Cardinals friends: 31
Madalyn has 	 fav team: Cardinals 	 RedSox friends: 37 	 Cardinals friends: 53
Madalynn has 	 fav team: Cardinals 	 RedSox friends: 23 	 Cardinals friends: 43
Madden has 	 fav team: Red Sox 	 RedSox friends: 36 	 Cardinals friends: 33
Maddison has 	 fav team: Cardinals 	 RedSox friends: 35 	 Cardinals friends: 53
Maddox has 	 fav team: Cardinals 	 RedSox friends: 43 	 Cardinals friends: 56
Madeleine has 	 fav team: Red Sox 	 RedSox friends: 60 	 Cardinals friends: 29
Madeline has 	 fav team: Cardinals 	 RedSox friends: 31 	 Cardinals friends: 45
Madelyn has 	 fav team: Red Sox 	 RedSox friends: 46 	 Cardinals friends: 30
Madelynn has 	 fav team: Red Sox 	 RedSox friends: 59 	 Cardinals friends: 25
Madilyn has 	 fav team: Red Sox 	 RedSox friends: 39 	 Cardinals friends: 35
Madilynn has 	 fav team: Red Sox 	 RedSox friends: 52 	 Cardinals friends: 24
Madison has 	 fav team: Cardinals 	 RedSox friends: 28 	 Cardinals friends: 49
Madisyn has 	 fav team: Cardinals 	 RedSox friends: 33 	 Cardinals friends: 48
Madyson has 	 fav team: Red Sox 	 RedSox friends: 46 	 Cardinals friends: 24
Mae has 	 fav team: Cardinals 	 RedSox friends: 28 	 Cardinals friends: 64
Maeve has 	 fav team: Cardinals 	 RedSox friends: 30 	 Cardinals friends: 50
Maggie has 	 fav team: Cardinals 	 RedSox friends: 28 	 Cardinals friends: 41
Maia has 	 fav team: Red Sox 	 RedSox friends: 45 	 Cardinals friends: 32
Maison has 	 fav team: Cardinals 	 RedSox friends: 31 	 Cardinals friends: 45
Major has 	 fav team: Red Sox 	 RedSox friends: 49 	 Cardinals friends: 22
Makai has 	 fav team: Red Sox 	 RedSox friends: 55 	 Cardinals friends: 41
Makayla has 	 fav team: Red Sox 	 RedSox friends: 49 	 Cardinals friends: 37
Makenna has 	 fav team: Red Sox 	 RedSox friends: 50 	 Cardinals friends: 33
Makenzie has 	 fav team: Red Sox 	 RedSox friends: 51 	 Cardinals friends: 32
Makhi has 	 fav team: Cardinals 	 RedSox friends: 29 	 Cardinals friends: 46
Malachi has 	 fav team: Red Sox 	 RedSox friends: 53 	 Cardinals friends: 32
Malakai has 	 fav team: Red Sox 	 RedSox friends: 53 	 Cardinals friends: 24
Malaki has 	 fav team: Red Sox 	 RedSox friends: 55 	 Cardinals friends: 30
Malaya has 	 fav team: Red Sox 	 RedSox friends: 54 	 Cardinals friends: 28
Malaysia has 	 fav team: Red Sox 	 RedSox friends: 45 	 Cardinals friends: 25
Malcolm has 	 fav team: Cardinals 	 RedSox friends: 31 	 Cardinals friends: 44
Maleah has 	 fav team: Red Sox 	 RedSox friends: 50 	 Cardinals friends: 38
Malia has 	 fav team: Cardinals 	 RedSox friends: 25 	 Cardinals friends: 35
Maliah has 	 fav team: Red Sox 	 RedSox friends: 58 	 Cardinals friends: 34
Malik has 	 fav team: Cardinals 	 RedSox friends: 29 	 Cardinals friends: 47
Maliyah has 	 fav team: Red Sox 	 RedSox friends: 47 	 Cardinals friends: 27
Mallory has 	 fav team: Cardinals 	 RedSox friends: 27 	 Cardinals friends: 35
Manuel has 	 fav team: Red Sox 	 RedSox friends: 49 	 Cardinals friends: 23
Mara has 	 fav team: Red Sox 	 RedSox friends: 42 	 Cardinals friends: 22
Marc has 	 fav team: Red Sox 	 RedSox friends: 46 	 Cardinals friends: 30
Marcel has 	 fav team: Cardinals 	 RedSox friends: 31 	 Cardinals friends: 46
Marcelo has 	 fav team: Red Sox 	 RedSox friends: 47 	 Cardinals friends: 33
Marco has 	 fav team: Red Sox 	 RedSox friends: 44 	 Cardinals friends: 27
Marcos has 	 fav team: Red Sox 	 RedSox friends: 38 	 Cardinals friends: 24
Marcus has 	 fav team: Cardinals 	 RedSox friends: 27 	 Cardinals friends: 45
Margaret has 	 fav team: Cardinals 	 RedSox friends: 30 	 Cardinals friends: 49
Maria has 	 fav team: Cardinals 	 RedSox friends: 24 	 Cardinals friends: 51
Mariah has 	 fav team: Red Sox 	 RedSox friends: 47 	 Cardinals friends: 24
Mariam has 	 fav team: Cardinals 	 RedSox friends: 26 	 Cardinals friends: 58
Mariana has 	 fav team: Cardinals 	 RedSox friends: 25 	 Cardinals friends: 59
Marianna has 	 fav team: Red Sox 	 RedSox friends: 50 	 Cardinals friends: 35
Marie has 	 fav team: Red Sox 	 RedSox friends: 46 	 Cardinals friends: 27
Marilyn has 	 fav team: Red Sox 	 RedSox friends: 56 	 Cardinals friends: 31
Marina has 	 fav team: Red Sox 	 RedSox friends: 45 	 Cardinals friends: 32
Mario has 	 fav team: Cardinals 	 RedSox friends: 32 	 Cardinals friends: 42
Marisa has 	 fav team: Red Sox 	 RedSox friends: 49 	 Cardinals friends: 32
Marisol has 	 fav team: Cardinals 	 RedSox friends: 30 	 Cardinals friends: 43
Marissa has 	 fav team: Red Sox 	 RedSox friends: 39 	 Cardinals friends: 29
Maritza has 	 fav team: Red Sox 	 RedSox friends: 57 	 Cardinals friends: 22
Mariyah has 	 fav team: Cardinals 	 RedSox friends: 28 	 Cardinals friends: 44
Mark has 	 fav team: Red Sox 	 RedSox friends: 42 	 Cardinals friends: 23
Markus has 	 fav team: Cardinals 	 RedSox friends: 32 	 Cardinals friends: 40
Marlee has 	 fav team: Cardinals 	 RedSox friends: 28 	 Cardinals friends: 47
Marlene has 	 fav team: Cardinals 	 RedSox friends: 30 	 Cardinals friends: 47
Marley has 	 fav team: Red Sox 	 RedSox friends: 47 	 Cardinals friends: 30
Marlon has 	 fav team: Red Sox 	 RedSox friends: 50 	 Cardinals friends: 36
Marquis has 	 fav team: Red Sox 	 RedSox friends: 48 	 Cardinals friends: 34
Marshall has 	 fav team: Cardinals 	 RedSox friends: 31 	 Cardinals friends: 60
Martha has 	 fav team: Red Sox 	 RedSox friends: 45 	 Cardinals friends: 28
Martin has 	 fav team: Cardinals 	 RedSox friends: 34 	 Cardinals friends: 41
Marvin has 	 fav team: Cardinals 	 RedSox friends: 24 	 Cardinals friends: 40
Mary has 	 fav team: Cardinals 	 RedSox friends: 24 	 Cardinals friends: 47
Maryam has 	 fav team: Red Sox 	 RedSox friends: 51 	 Cardinals friends: 27
Masen has 	 fav team: Cardinals 	 RedSox friends: 28 	 Cardinals friends: 47
Mason has 	 fav team: Red Sox 	 RedSox friends: 59 	 Cardinals friends: 22
Mateo has 	 fav team: Red Sox 	 RedSox friends: 56 	 Cardinals friends: 29
Mathew has 	 fav team: Red Sox 	 RedSox friends: 49 	 Cardinals friends: 24
Mathias has 	 fav team: Cardinals 	 RedSox friends: 32 	 Cardinals friends: 43
Matias has 	 fav team: Cardinals 	 RedSox friends: 34 	 Cardinals friends: 39
Matilda has 	 fav team: Red Sox 	 RedSox friends: 50 	 Cardinals friends: 32
Matteo has 	 fav team: Cardinals 	 RedSox friends: 32 	 Cardinals friends: 45
Matthew has 	 fav team: Red Sox 	 RedSox friends: 44 	 Cardinals friends: 19
Matthias has 	 fav team: Red Sox 	 RedSox friends: 43 	 Cardinals friends: 33
Mattie has 	 fav team: Red Sox 	 RedSox friends: 61 	 Cardinals friends: 38
Maurice has 	 fav team: Cardinals 	 RedSox friends: 38 	 Cardinals friends: 38
Mauricio has 	 fav team: Red Sox 	 RedSox friends: 55 	 Cardinals friends: 26
Maverick has 	 fav team: Red Sox 	 RedSox friends: 49 	 Cardinals friends: 31
Max has 	 fav team: Red Sox 	 RedSox friends: 48 	 Cardinals friends: 28
Maxim has 	 fav team: Cardinals 	 RedSox friends: 31 	 Cardinals friends: 55
Maximilian has 	 fav team: Red Sox 	 RedSox friends: 38 	 Cardinals friends: 34
Maximiliano has 	 fav team: Cardinals 	 RedSox friends: 23 	 Cardinals friends: 54
Maximo has 	 fav team: Red Sox 	 RedSox friends: 47 	 Cardinals friends: 17
Maximus has 	 fav team: Red Sox 	 RedSox friends: 43 	 Cardinals friends: 18
Maxton has 	 fav team: Red Sox 	 RedSox friends: 52 	 Cardinals friends: 24
Maxwell has 	 fav team: Red Sox 	 RedSox friends: 45 	 Cardinals friends: 33
Maya has 	 fav team: Cardinals 	 RedSox friends: 48 	 Cardinals friends: 45
Mayson has 	 fav team: Cardinals 	 RedSox friends: 24 	 Cardinals friends: 63
Mckayla has 	 fav team: Red Sox 	 RedSox friends: 40 	 Cardinals friends: 29
Mckenna has 	 fav team: Cardinals 	 RedSox friends: 31 	 Cardinals friends: 50
Mckenzie has 	 fav team: Red Sox 	 RedSox friends: 46 	 Cardinals friends: 26
Mckinley has 	 fav team: Red Sox 	 RedSox friends: 62 	 Cardinals friends: 29
Meadow has 	 fav team: Cardinals 	 RedSox friends: 29 	 Cardinals friends: 56
Megan has 	 fav team: Red Sox 	 RedSox friends: 56 	 Cardinals friends: 27
Meghan has 	 fav team: Cardinals 	 RedSox friends: 31 	 Cardinals friends: 54
Mekhi has 	 fav team: Cardinals 	 RedSox friends: 27 	 Cardinals friends: 50
Melanie has 	 fav team: Red Sox 	 RedSox friends: 38 	 Cardinals friends: 34
Melany has 	 fav team: Cardinals 	 RedSox friends: 26 	 Cardinals friends: 46
Melina has 	 fav team: Red Sox 	 RedSox friends: 40 	 Cardinals friends: 32
Melissa has 	 fav team: Red Sox 	 RedSox friends: 45 	 Cardinals friends: 28
Melody has 	 fav team: Red Sox 	 RedSox friends: 58 	 Cardinals friends: 25
Melvin has 	 fav team: Red Sox 	 RedSox friends: 40 	 Cardinals friends: 27
Memphis has 	 fav team: Cardinals 	 RedSox friends: 29 	 Cardinals friends: 39
Mercedes has 	 fav team: Cardinals 	 RedSox friends: 27 	 Cardinals friends: 53
Meredith has 	 fav team: Cardinals 	 RedSox friends: 24 	 Cardinals friends: 42
Messiah has 	 fav team: Cardinals 	 RedSox friends: 35 	 Cardinals friends: 33
Mia has 	 fav team: Cardinals 	 RedSox friends: 32 	 Cardinals friends: 43
Miah has 	 fav team: Cardinals 	 RedSox friends: 28 	 Cardinals friends: 32
Micah has 	 fav team: Cardinals 	 RedSox friends: 33 	 Cardinals friends: 43
Michael has 	 fav team: Cardinals 	 RedSox friends: 39 	 Cardinals friends: 47
Michaela has 	 fav team: Red Sox 	 RedSox friends: 44 	 Cardinals friends: 29
Micheal has 	 fav team: Red Sox 	 RedSox friends: 61 	 Cardinals friends: 27
Michelle has 	 fav team: Cardinals 	 RedSox friends: 21 	 Cardinals friends: 56
Miguel has 	 fav team: Red Sox 	 RedSox friends: 48 	 Cardinals friends: 26
Mikaela has 	 fav team: Red Sox 	 RedSox friends: 55 	 Cardinals friends: 24
Mikayla has 	 fav team: Red Sox 	 RedSox friends: 46 	 Cardinals friends: 34
Mike has 	 fav team: Red Sox 	 RedSox friends: 54 	 Cardinals friends: 23
Mila has 	 fav team: Red Sox 	 RedSox friends: 50 	 Cardinals friends: 34
Milan has 	 fav team: Cardinals 	 RedSox friends: 23 	 Cardinals friends: 35
Milana has 	 fav team: Cardinals 	 RedSox friends: 26 	 Cardinals friends: 43
Milania has 	 fav team: Cardinals 	 RedSox friends: 28 	 Cardinals friends: 46
Milena has 	 fav team: Cardinals 	 RedSox friends: 32 	 Cardinals friends: 46
Miles has 	 fav team: Cardinals 	 RedSox friends: 31 	 Cardinals friends: 51
Miley has 	 fav team: Cardinals 	 RedSox friends: 28 	 Cardinals friends: 42
Millie has 	 fav team: Cardinals 	 RedSox friends: 28 	 Cardinals friends: 40
Milo has 	 fav team: Cardinals 	 RedSox friends: 26 	 Cardinals friends: 37
Mina has 	 fav team: Cardinals 	 RedSox friends: 37 	 Cardinals friends: 45
Mira has 	 fav team: Red Sox 	 RedSox friends: 58 	 Cardinals friends: 22
Miracle has 	 fav team: Cardinals 	 RedSox friends: 26 	 Cardinals friends: 31
Miranda has 	 fav team: Cardinals 	 RedSox friends: 32 	 Cardinals friends: 46
Miriam has 	 fav team: Red Sox 	 RedSox friends: 39 	 Cardinals friends: 27
Misael has 	 fav team: Red Sox 	 RedSox friends: 49 	 Cardinals friends: 28
Mitchell has 	 fav team: Cardinals 	 RedSox friends: 28 	 Cardinals friends: 50
Miya has 	 fav team: Red Sox 	 RedSox friends: 49 	 Cardinals friends: 26
Mohamed has 	 fav team: Cardinals 	 RedSox friends: 28 	 Cardinals friends: 48
Mohammad has 	 fav team: Red Sox 	 RedSox friends: 49 	 Cardinals friends: 25
Mohammed has 	 fav team: Cardinals 	 RedSox friends: 26 	 Cardinals friends: 54
Moises has 	 fav team: Red Sox 	 RedSox friends: 51 	 Cardinals friends: 22
Mollie has 	 fav team: Red Sox 	 RedSox friends: 72 	 Cardinals friends: 21
Molly has 	 fav team: Cardinals 	 RedSox friends: 25 	 Cardinals friends: 44
Monica has 	 fav team: Cardinals 	 RedSox friends: 32 	 Cardinals friends: 40
Monroe has 	 fav team: Red Sox 	 RedSox friends: 47 	 Cardinals friends: 25
Morgan has 	 fav team: Cardinals 	 RedSox friends: 30 	 Cardinals friends: 49
Moriah has 	 fav team: Red Sox 	 RedSox friends: 49 	 Cardinals friends: 26
Moses has 	 fav team: Cardinals 	 RedSox friends: 34 	 Cardinals friends: 46
Moshe has 	 fav team: Red Sox 	 RedSox friends: 50 	 Cardinals friends: 22
Muhammad has 	 fav team: Cardinals 	 RedSox friends: 21 	 Cardinals friends: 52
Mustafa has 	 fav team: Cardinals 	 RedSox friends: 29 	 Cardinals friends: 59
Mya has 	 fav team: Cardinals 	 RedSox friends: 26 	 Cardinals friends: 48
Myah has 	 fav team: Red Sox 	 RedSox friends: 51 	 Cardinals friends: 35
Myla has 	 fav team: Red Sox 	 RedSox friends: 46 	 Cardinals friends: 27
Myles has 	 fav team: Cardinals 	 RedSox friends: 36 	 Cardinals friends: 41
Myra has 	 fav team: Cardinals 	 RedSox friends: 29 	 Cardinals friends: 49
Nadia has 	 fav team: Cardinals 	 RedSox friends: 30 	 Cardinals friends: 53
Nahla has 	 fav team: Red Sox 	 RedSox friends: 54 	 Cardinals friends: 22
Nancy has 	 fav team: Red Sox 	 RedSox friends: 46 	 Cardinals friends: 27
Naomi has 	 fav team: Red Sox 	 RedSox friends: 38 	 Cardinals friends: 24
Nash has 	 fav team: Cardinals 	 RedSox friends: 22 	 Cardinals friends: 53
Nasir has 	 fav team: Red Sox 	 RedSox friends: 36 	 Cardinals friends: 35
Natalee has 	 fav team: Red Sox 	 RedSox friends: 31 	 Cardinals friends: 27
Natalia has 	 fav team: Red Sox 	 RedSox friends: 59 	 Cardinals friends: 25
Natalie has 	 fav team: Cardinals 	 RedSox friends: 31 	 Cardinals friends: 42
Nataly has 	 fav team: Cardinals 	 RedSox friends: 26 	 Cardinals friends: 51
Natalya has 	 fav team: Red Sox 	 RedSox friends: 35 	 Cardinals friends: 17
Natasha has 	 fav team: Red Sox 	 RedSox friends: 70 	 Cardinals friends: 18
Nathalie has 	 fav team: Cardinals 	 RedSox friends: 28 	 Cardinals friends: 48
Nathaly has 	 fav team: Red Sox 	 RedSox friends: 54 	 Cardinals friends: 26
Nathan has 	 fav team: Red Sox 	 RedSox friends: 54 	 Cardinals friends: 20
Nathanael has 	 fav team: Red Sox 	 RedSox friends: 56 	 Cardinals friends: 31
Nathaniel has 	 fav team: Cardinals 	 RedSox friends: 37 	 Cardinals friends: 47
Nayeli has 	 fav team: Cardinals 	 RedSox friends: 24 	 Cardinals friends: 53
Nehemiah has 	 fav team: Red Sox 	 RedSox friends: 47 	 Cardinals friends: 31
Neil has 	 fav team: Cardinals 	 RedSox friends: 30 	 Cardinals friends: 50
Nelson has 	 fav team: Cardinals 	 RedSox friends: 26 	 Cardinals friends: 39
Nevaeh has 	 fav team: Cardinals 	 RedSox friends: 25 	 Cardinals friends: 49
Neymar has 	 fav team: Cardinals 	 RedSox friends: 21 	 Cardinals friends: 51
Nia has 	 fav team: Red Sox 	 RedSox friends: 38 	 Cardinals friends: 31
Nicholas has 	 fav team: Red Sox 	 RedSox friends: 47 	 Cardinals friends: 28
Nickolas has 	 fav team: Cardinals 	 RedSox friends: 33 	 Cardinals friends: 36
Nico has 	 fav team: Red Sox 	 RedSox friends: 53 	 Cardinals friends: 38
Nicolas has 	 fav team: Cardinals 	 RedSox friends: 35 	 Cardinals friends: 52
Nicole has 	 fav team: Red Sox 	 RedSox friends: 53 	 Cardinals friends: 38
Niko has 	 fav team: Cardinals 	 RedSox friends: 22 	 Cardinals friends: 55
Nikolai has 	 fav team: Cardinals 	 RedSox friends: 38 	 Cardinals friends: 55
Nikolas has 	 fav team: Red Sox 	 RedSox friends: 51 	 Cardinals friends: 19
Nina has 	 fav team: Cardinals 	 RedSox friends: 34 	 Cardinals friends: 44
Nixon has 	 fav team: Cardinals 	 RedSox friends: 31 	 Cardinals friends: 32
Noah has 	 fav team: Red Sox 	 RedSox friends: 50 	 Cardinals friends: 26
Noe has 	 fav team: Cardinals 	 RedSox friends: 34 	 Cardinals friends: 44
Noel has 	 fav team: Red Sox 	 RedSox friends: 45 	 Cardinals friends: 26
Noelle has 	 fav team: Red Sox 	 RedSox friends: 59 	 Cardinals friends: 34
Noemi has 	 fav team: Red Sox 	 RedSox friends: 42 	 Cardinals friends: 29
Nola has 	 fav team: Red Sox 	 RedSox friends: 58 	 Cardinals friends: 32
Nolan has 	 fav team: Red Sox 	 RedSox friends: 38 	 Cardinals friends: 30
Nora has 	 fav team: Cardinals 	 RedSox friends: 33 	 Cardinals friends: 39
Norah has 	 fav team: Cardinals 	 RedSox friends: 23 	 Cardinals friends: 46
Nova has 	 fav team: Red Sox 	 RedSox friends: 49 	 Cardinals friends: 31
Nyla has 	 fav team: Red Sox 	 RedSox friends: 42 	 Cardinals friends: 29
Nylah has 	 fav team: Cardinals 	 RedSox friends: 28 	 Cardinals friends: 48
Oakley has 	 fav team: Cardinals 	 RedSox friends: 35 	 Cardinals friends: 37
Odin has 	 fav team: Cardinals 	 RedSox friends: 26 	 Cardinals friends: 42
Olive has 	 fav team: Red Sox 	 RedSox friends: 53 	 Cardinals friends: 30
Oliver has 	 fav team: Cardinals 	 RedSox friends: 25 	 Cardinals friends: 51
Olivia has 	 fav team: Cardinals 	 RedSox friends: 26 	 Cardinals friends: 52
Omar has 	 fav team: Red Sox 	 RedSox friends: 50 	 Cardinals friends: 20
Omari has 	 fav team: Cardinals 	 RedSox friends: 32 	 Cardinals friends: 50
Orion has 	 fav team: Red Sox 	 RedSox friends: 54 	 Cardinals friends: 28
Orlando has 	 fav team: Cardinals 	 RedSox friends: 28 	 Cardinals friends: 56
Oscar has 	 fav team: Red Sox 	 RedSox friends: 46 	 Cardinals friends: 23
Osvaldo has 	 fav team: Red Sox 	 RedSox friends: 54 	 Cardinals friends: 20
Otto has 	 fav team: Cardinals 	 RedSox friends: 24 	 Cardinals friends: 60
Owen has 	 fav team: Cardinals 	 RedSox friends: 37 	 Cardinals friends: 62
Pablo has 	 fav team: Red Sox 	 RedSox friends: 45 	 Cardinals friends: 31
Paige has 	 fav team: Red Sox 	 RedSox friends: 49 	 Cardinals friends: 24
Paislee has 	 fav team: Cardinals 	 RedSox friends: 35 	 Cardinals friends: 51
Paisley has 	 fav team: Red Sox 	 RedSox friends: 40 	 Cardinals friends: 29
Paityn has 	 fav team: Cardinals 	 RedSox friends: 23 	 Cardinals friends: 37
Paloma has 	 fav team: Cardinals 	 RedSox friends: 24 	 Cardinals friends: 41
Paola has 	 fav team: Cardinals 	 RedSox friends: 41 	 Cardinals friends: 44
Paris has 	 fav team: Red Sox 	 RedSox friends: 43 	 Cardinals friends: 38
Parker has 	 fav team: Cardinals 	 RedSox friends: 29 	 Cardinals friends: 34
Patience has 	 fav team: Cardinals 	 RedSox friends: 29 	 Cardinals friends: 58
Patricia has 	 fav team: Cardinals 	 RedSox friends: 33 	 Cardinals friends: 53
Patrick has 	 fav team: Cardinals 	 RedSox friends: 28 	 Cardinals friends: 46
Paul has 	 fav team: Red Sox 	 RedSox friends: 54 	 Cardinals friends: 24
Paula has 	 fav team: Red Sox 	 RedSox friends: 42 	 Cardinals friends: 28
Paulina has 	 fav team: Cardinals 	 RedSox friends: 29 	 Cardinals friends: 51
Paxton has 	 fav team: Red Sox 	 RedSox friends: 41 	 Cardinals friends: 23
Payton has 	 fav team: Red Sox 	 RedSox friends: 53 	 Cardinals friends: 19
Pearl has 	 fav team: Red Sox 	 RedSox friends: 53 	 Cardinals friends: 37
Pedro has 	 fav team: Cardinals 	 RedSox friends: 30 	 Cardinals friends: 54
Penelope has 	 fav team: Red Sox 	 RedSox friends: 45 	 Cardinals friends: 36
Perla has 	 fav team: Cardinals 	 RedSox friends: 28 	 Cardinals friends: 54
Peter has 	 fav team: Red Sox 	 RedSox friends: 66 	 Cardinals friends: 23
Peyton has 	 fav team: Red Sox 	 RedSox friends: 52 	 Cardinals friends: 40
Philip has 	 fav team: Red Sox 	 RedSox friends: 45 	 Cardinals friends: 22
Phillip has 	 fav team: Red Sox 	 RedSox friends: 47 	 Cardinals friends: 28
Phoebe has 	 fav team: Cardinals 	 RedSox friends: 36 	 Cardinals friends: 58
Phoenix has 	 fav team: Red Sox 	 RedSox friends: 49 	 Cardinals friends: 34
Pierce has 	 fav team: Red Sox 	 RedSox friends: 52 	 Cardinals friends: 31
Piper has 	 fav team: Red Sox 	 RedSox friends: 39 	 Cardinals friends: 31
Porter has 	 fav team: Red Sox 	 RedSox friends: 35 	 Cardinals friends: 36
Presley has 	 fav team: Cardinals 	 RedSox friends: 26 	 Cardinals friends: 36
Preston has 	 fav team: Cardinals 	 RedSox friends: 27 	 Cardinals friends: 54
Prince has 	 fav team: Red Sox 	 RedSox friends: 50 	 Cardinals friends: 27
Princeton has 	 fav team: Cardinals 	 RedSox friends: 23 	 Cardinals friends: 45
Priscilla has 	 fav team: Red Sox 	 RedSox friends: 48 	 Cardinals friends: 24
Quentin has 	 fav team: Red Sox 	 RedSox friends: 44 	 Cardinals friends: 36
Quincy has 	 fav team: Red Sox 	 RedSox friends: 53 	 Cardinals friends: 26
Quinn has 	 fav team: Cardinals 	 RedSox friends: 31 	 Cardinals friends: 47
Quintin has 	 fav team: Cardinals 	 RedSox friends: 36 	 Cardinals friends: 45
Quinton has 	 fav team: Red Sox 	 RedSox friends: 60 	 Cardinals friends: 28
Rachael has 	 fav team: Red Sox 	 RedSox friends: 51 	 Cardinals friends: 31
Rachel has 	 fav team: Cardinals 	 RedSox friends: 34 	 Cardinals friends: 43
Raegan has 	 fav team: Cardinals 	 RedSox friends: 30 	 Cardinals friends: 54
Raelyn has 	 fav team: Red Sox 	 RedSox friends: 51 	 Cardinals friends: 25
Raelynn has 	 fav team: Cardinals 	 RedSox friends: 20 	 Cardinals friends: 46
Rafael has 	 fav team: Red Sox 	 RedSox friends: 53 	 Cardinals friends: 32
Raiden has 	 fav team: Red Sox 	 RedSox friends: 43 	 Cardinals friends: 33
Raina has 	 fav team: Cardinals 	 RedSox friends: 32 	 Cardinals friends: 46
Ramiro has 	 fav team: Cardinals 	 RedSox friends: 27 	 Cardinals friends: 57
Ramon has 	 fav team: Red Sox 	 RedSox friends: 59 	 Cardinals friends: 26
Randall has 	 fav team: Cardinals 	 RedSox friends: 25 	 Cardinals friends: 54
Randy has 	 fav team: Red Sox 	 RedSox friends: 52 	 Cardinals friends: 27
Raphael has 	 fav team: Cardinals 	 RedSox friends: 32 	 Cardinals friends: 46
Raquel has 	 fav team: Red Sox 	 RedSox friends: 54 	 Cardinals friends: 19
Rashad has 	 fav team: Red Sox 	 RedSox friends: 42 	 Cardinals friends: 32
Raul has 	 fav team: Red Sox 	 RedSox friends: 43 	 Cardinals friends: 32
Raven has 	 fav team: Cardinals 	 RedSox friends: 31 	 Cardinals friends: 47
Ray has 	 fav team: Red Sox 	 RedSox friends: 49 	 Cardinals friends: 28
Rayan has 	 fav team: Red Sox 	 RedSox friends: 48 	 Cardinals friends: 33
Rayden has 	 fav team: Red Sox 	 RedSox friends: 48 	 Cardinals friends: 26
Raylan has 	 fav team: Cardinals 	 RedSox friends: 31 	 Cardinals friends: 45
Raylee has 	 fav team: Red Sox 	 RedSox friends: 45 	 Cardinals friends: 32
Raymond has 	 fav team: Cardinals 	 RedSox friends: 30 	 Cardinals friends: 43
Rayna has 	 fav team: Cardinals 	 RedSox friends: 34 	 Cardinals friends: 50
Rayne has 	 fav team: Red Sox 	 RedSox friends: 41 	 Cardinals friends: 25
Reagan has 	 fav team: Red Sox 	 RedSox friends: 32 	 Cardinals friends: 29
Rebecca has 	 fav team: Red Sox 	 RedSox friends: 48 	 Cardinals friends: 30
Rebekah has 	 fav team: Cardinals 	 RedSox friends: 31 	 Cardinals friends: 41
Reece has 	 fav team: Cardinals 	 RedSox friends: 30 	 Cardinals friends: 54
Reed has 	 fav team: Red Sox 	 RedSox friends: 45 	 Cardinals friends: 25
Reese has 	 fav team: Red Sox 	 RedSox friends: 49 	 Cardinals friends: 25
Regan has 	 fav team: Cardinals 	 RedSox friends: 42 	 Cardinals friends: 36
Regina has 	 fav team: Red Sox 	 RedSox friends: 60 	 Cardinals friends: 36
Reginald has 	 fav team: Red Sox 	 RedSox friends: 53 	 Cardinals friends: 32
Reid has 	 fav team: Cardinals 	 RedSox friends: 36 	 Cardinals friends: 42
Remington has 	 fav team: Cardinals 	 RedSox friends: 26 	 Cardinals friends: 63
Remy has 	 fav team: Cardinals 	 RedSox friends: 24 	 Cardinals friends: 46
Renata has 	 fav team: Red Sox 	 RedSox friends: 48 	 Cardinals friends: 25
Rene has 	 fav team: Cardinals 	 RedSox friends: 25 	 Cardinals friends: 49
Renee has 	 fav team: Cardinals 	 RedSox friends: 30 	 Cardinals friends: 51
Reuben has 	 fav team: Cardinals 	 RedSox friends: 22 	 Cardinals friends: 42
Rex has 	 fav team: Cardinals 	 RedSox friends: 27 	 Cardinals friends: 49
Rey has 	 fav team: Red Sox 	 RedSox friends: 48 	 Cardinals friends: 33
Reyna has 	 fav team: Red Sox 	 RedSox friends: 50 	 Cardinals friends: 25
Rhett has 	 fav team: Cardinals 	 RedSox friends: 30 	 Cardinals friends: 45
Rhys has 	 fav team: Cardinals 	 RedSox friends: 28 	 Cardinals friends: 56
Ricardo has 	 fav team: Cardinals 	 RedSox friends: 43 	 Cardinals friends: 43
Richard has 	 fav team: Red Sox 	 RedSox friends: 53 	 Cardinals friends: 25
Ricky has 	 fav team: Red Sox 	 RedSox friends: 49 	 Cardinals friends: 26
Rihanna has 	 fav team: Red Sox 	 RedSox friends: 41 	 Cardinals friends: 32
Riley has 	 fav team: Red Sox 	 RedSox friends: 49 	 Cardinals friends: 39
River has 	 fav team: Cardinals 	 RedSox friends: 20 	 Cardinals friends: 43
Riya has 	 fav team: Red Sox 	 RedSox friends: 42 	 Cardinals friends: 33
Robert has 	 fav team: Cardinals 	 RedSox friends: 34 	 Cardinals friends: 55
Roberto has 	 fav team: Cardinals 	 RedSox friends: 33 	 Cardinals friends: 53
Rocco has 	 fav team: Red Sox 	 RedSox friends: 48 	 Cardinals friends: 22
Roderick has 	 fav team: Cardinals 	 RedSox friends: 43 	 Cardinals friends: 45
Rodney has 	 fav team: Cardinals 	 RedSox friends: 31 	 Cardinals friends: 48
Rodolfo has 	 fav team: Red Sox 	 RedSox friends: 48 	 Cardinals friends: 24
Rodrigo has 	 fav team: Cardinals 	 RedSox friends: 31 	 Cardinals friends: 51
Rogelio has 	 fav team: Cardinals 	 RedSox friends: 36 	 Cardinals friends: 50
Roger has 	 fav team: Red Sox 	 RedSox friends: 61 	 Cardinals friends: 37
Rohan has 	 fav team: Cardinals 	 RedSox friends: 25 	 Cardinals friends: 40
Roland has 	 fav team: Red Sox 	 RedSox friends: 51 	 Cardinals friends: 28
Rolando has 	 fav team: Cardinals 	 RedSox friends: 30 	 Cardinals friends: 51
Roman has 	 fav team: Cardinals 	 RedSox friends: 41 	 Cardinals friends: 33
Romeo has 	 fav team: Cardinals 	 RedSox friends: 26 	 Cardinals friends: 43
Ronald has 	 fav team: Red Sox 	 RedSox friends: 51 	 Cardinals friends: 32
Ronan has 	 fav team: Cardinals 	 RedSox friends: 34 	 Cardinals friends: 39
Ronin has 	 fav team: Cardinals 	 RedSox friends: 29 	 Cardinals friends: 53
Ronnie has 	 fav team: Red Sox 	 RedSox friends: 51 	 Cardinals friends: 24
Rory has 	 fav team: Red Sox 	 RedSox friends: 53 	 Cardinals friends: 25
Rosa has 	 fav team: Cardinals 	 RedSox friends: 23 	 Cardinals friends: 57
Rosalie has 	 fav team: Cardinals 	 RedSox friends: 37 	 Cardinals friends: 46
Rose has 	 fav team: Cardinals 	 RedSox friends: 42 	 Cardinals friends: 44
Roselyn has 	 fav team: Red Sox 	 RedSox friends: 57 	 Cardinals friends: 24
Rosemary has 	 fav team: Red Sox 	 RedSox friends: 50 	 Cardinals friends: 34
Ross has 	 fav team: Red Sox 	 RedSox friends: 49 	 Cardinals friends: 28
Rowan has 	 fav team: Red Sox 	 RedSox friends: 35 	 Cardinals friends: 29
Rowen has 	 fav team: Cardinals 	 RedSox friends: 34 	 Cardinals friends: 57
Roy has 	 fav team: Cardinals 	 RedSox friends: 33 	 Cardinals friends: 46
Royce has 	 fav team: Red Sox 	 RedSox friends: 40 	 Cardinals friends: 31
Ruben has 	 fav team: Cardinals 	 RedSox friends: 30 	 Cardinals friends: 43
Ruby has 	 fav team: Cardinals 	 RedSox friends: 20 	 Cardinals friends: 52
Rudy has 	 fav team: Cardinals 	 RedSox friends: 35 	 Cardinals friends: 60
Russell has 	 fav team: Cardinals 	 RedSox friends: 28 	 Cardinals friends: 47
Ruth has 	 fav team: Red Sox 	 RedSox friends: 38 	 Cardinals friends: 29
Ryan has 	 fav team: Red Sox 	 RedSox friends: 39 	 Cardinals friends: 25
Ryann has 	 fav team: Cardinals 	 RedSox friends: 26 	 Cardinals friends: 38
Ryder has 	 fav team: Cardinals 	 RedSox friends: 35 	 Cardinals friends: 44
Ryker has 	 fav team: Cardinals 	 RedSox friends: 22 	 Cardinals friends: 40
Rylan has 	 fav team: Red Sox 	 RedSox friends: 57 	 Cardinals friends: 25
Ryland has 	 fav team: Red Sox 	 RedSox friends: 45 	 Cardinals friends: 36
Rylee has 	 fav team: Red Sox 	 RedSox friends: 50 	 Cardinals friends: 30
Ryleigh has 	 fav team: Cardinals 	 RedSox friends: 24 	 Cardinals friends: 43
Rylen has 	 fav team: Red Sox 	 RedSox friends: 47 	 Cardinals friends: 37
Rylie has 	 fav team: Red Sox 	 RedSox friends: 50 	 Cardinals friends: 28
Saanvi has 	 fav team: Red Sox 	 RedSox friends: 50 	 Cardinals friends: 39
Sabrina has 	 fav team: Red Sox 	 RedSox friends: 47 	 Cardinals friends: 28
Sadie has 	 fav team: Cardinals 	 RedSox friends: 32 	 Cardinals friends: 46
Sage has 	 fav team: Cardinals 	 RedSox friends: 31 	 Cardinals friends: 58
Saige has 	 fav team: Cardinals 	 RedSox friends: 30 	 Cardinals friends: 44
Salma has 	 fav team: Red Sox 	 RedSox friends: 38 	 Cardinals friends: 21
Salvador has 	 fav team: Red Sox 	 RedSox friends: 55 	 Cardinals friends: 39
Salvatore has 	 fav team: Red Sox 	 RedSox friends: 48 	 Cardinals friends: 32
Sam has 	 fav team: Red Sox 	 RedSox friends: 36 	 Cardinals friends: 29
Samantha has 	 fav team: Cardinals 	 RedSox friends: 17 	 Cardinals friends: 46
Samara has 	 fav team: Red Sox 	 RedSox friends: 52 	 Cardinals friends: 34
Samir has 	 fav team: Cardinals 	 RedSox friends: 29 	 Cardinals friends: 47
Samiyah has 	 fav team: Cardinals 	 RedSox friends: 34 	 Cardinals friends: 43
Samson has 	 fav team: Cardinals 	 RedSox friends: 30 	 Cardinals friends: 61
Samuel has 	 fav team: Red Sox 	 RedSox friends: 49 	 Cardinals friends: 27
Sandra has 	 fav team: Red Sox 	 RedSox friends: 60 	 Cardinals friends: 14
Saniya has 	 fav team: Cardinals 	 RedSox friends: 31 	 Cardinals friends: 48
Saniyah has 	 fav team: Cardinals 	 RedSox friends: 33 	 Cardinals friends: 48
Santiago has 	 fav team: Cardinals 	 RedSox friends: 30 	 Cardinals friends: 46
Santino has 	 fav team: Cardinals 	 RedSox friends: 31 	 Cardinals friends: 51
Santos has 	 fav team: Red Sox 	 RedSox friends: 43 	 Cardinals friends: 38
Sara has 	 fav team: Red Sox 	 RedSox friends: 48 	 Cardinals friends: 28
Sarah has 	 fav team: Red Sox 	 RedSox friends: 45 	 Cardinals friends: 20
Sarahi has 	 fav team: Red Sox 	 RedSox friends: 55 	 Cardinals friends: 26
Sarai has 	 fav team: Red Sox 	 RedSox friends: 47 	 Cardinals friends: 31
Sariah has 	 fav team: Red Sox 	 RedSox friends: 48 	 Cardinals friends: 20
Sariyah has 	 fav team: Red Sox 	 RedSox friends: 54 	 Cardinals friends: 30
Sasha has 	 fav team: Red Sox 	 RedSox friends: 43 	 Cardinals friends: 20
Saul has 	 fav team: Cardinals 	 RedSox friends: 28 	 Cardinals friends: 50
Savanna has 	 fav team: Red Sox 	 RedSox friends: 52 	 Cardinals friends: 23
Savannah has 	 fav team: Cardinals 	 RedSox friends: 31 	 Cardinals friends: 45
Sawyer has 	 fav team: Cardinals 	 RedSox friends: 39 	 Cardinals friends: 40
Scarlet has 	 fav team: Red Sox 	 RedSox friends: 54 	 Cardinals friends: 39
Scarlett has 	 fav team: Red Sox 	 RedSox friends: 62 	 Cardinals friends: 23
Scarlette has 	 fav team: Red Sox 	 RedSox friends: 51 	 Cardinals friends: 34
Scott has 	 fav team: Cardinals 	 RedSox friends: 27 	 Cardinals friends: 53
Seamus has 	 fav team: Cardinals 	 RedSox friends: 23 	 Cardinals friends: 45
Sean has 	 fav team: Red Sox 	 RedSox friends: 49 	 Cardinals friends: 33
Sebastian has 	 fav team: Cardinals 	 RedSox friends: 46 	 Cardinals friends: 58
Selah has 	 fav team: Red Sox 	 RedSox friends: 39 	 Cardinals friends: 24
Selena has 	 fav team: Cardinals 	 RedSox friends: 33 	 Cardinals friends: 39
Semaj has 	 fav team: Red Sox 	 RedSox friends: 48 	 Cardinals friends: 31
Serena has 	 fav team: Cardinals 	 RedSox friends: 33 	 Cardinals friends: 40
Serenity has 	 fav team: Red Sox 	 RedSox friends: 45 	 Cardinals friends: 36
Sergio has 	 fav team: Red Sox 	 RedSox friends: 52 	 Cardinals friends: 30
Seth has 	 fav team: Cardinals 	 RedSox friends: 29 	 Cardinals friends: 47
Shane has 	 fav team: Red Sox 	 RedSox friends: 45 	 Cardinals friends: 25
Shannon has 	 fav team: Red Sox 	 RedSox friends: 59 	 Cardinals friends: 17
Sharon has 	 fav team: Red Sox 	 RedSox friends: 44 	 Cardinals friends: 31
Shaun has 	 fav team: Red Sox 	 RedSox friends: 37 	 Cardinals friends: 33
Shawn has 	 fav team: Red Sox 	 RedSox friends: 54 	 Cardinals friends: 32
Shayla has 	 fav team: Cardinals 	 RedSox friends: 33 	 Cardinals friends: 48
Shelby has 	 fav team: Cardinals 	 RedSox friends: 27 	 Cardinals friends: 44
Sheldon has 	 fav team: Cardinals 	 RedSox friends: 31 	 Cardinals friends: 48
Sherlyn has 	 fav team: Red Sox 	 RedSox friends: 53 	 Cardinals friends: 33
Shiloh has 	 fav team: Red Sox 	 RedSox friends: 50 	 Cardinals friends: 30
Sidney has 	 fav team: Cardinals 	 RedSox friends: 28 	 Cardinals friends: 50
Siena has 	 fav team: Cardinals 	 RedSox friends: 29 	 Cardinals friends: 49
Sienna has 	 fav team: Cardinals 	 RedSox friends: 27 	 Cardinals friends: 52
Sierra has 	 fav team: Cardinals 	 RedSox friends: 24 	 Cardinals friends: 58
Silas has 	 fav team: Red Sox 	 RedSox friends: 54 	 Cardinals friends: 28
Simeon has 	 fav team: Red Sox 	 RedSox friends: 48 	 Cardinals friends: 22
Simon has 	 fav team: Red Sox 	 RedSox friends: 38 	 Cardinals friends: 33
Simone has 	 fav team: Red Sox 	 RedSox friends: 61 	 Cardinals friends: 26
Sincere has 	 fav team: Cardinals 	 RedSox friends: 31 	 Cardinals friends: 49
Sky has 	 fav team: Red Sox 	 RedSox friends: 56 	 Cardinals friends: 24
Skye has 	 fav team: Red Sox 	 RedSox friends: 61 	 Cardinals friends: 28
Skyla has 	 fav team: Red Sox 	 RedSox friends: 52 	 Cardinals friends: 27
Skylar has 	 fav team: Cardinals 	 RedSox friends: 35 	 Cardinals friends: 62
Skyler has 	 fav team: Cardinals 	 RedSox friends: 33 	 Cardinals friends: 56
Sloan has 	 fav team: Cardinals 	 RedSox friends: 33 	 Cardinals friends: 41
Sloane has 	 fav team: Red Sox 	 RedSox friends: 45 	 Cardinals friends: 25
Sofia has 	 fav team: Cardinals 	 RedSox friends: 32 	 Cardinals friends: 49
Sofie has 	 fav team: Red Sox 	 RedSox friends: 50 	 Cardinals friends: 28
Solomon has 	 fav team: Cardinals 	 RedSox friends: 30 	 Cardinals friends: 50
Sonia has 	 fav team: Cardinals 	 RedSox friends: 27 	 Cardinals friends: 42
Sonny has 	 fav team: Cardinals 	 RedSox friends: 30 	 Cardinals friends: 46
Sophia has 	 fav team: Red Sox 	 RedSox friends: 39 	 Cardinals friends: 32
Sophie has 	 fav team: Cardinals 	 RedSox friends: 29 	 Cardinals friends: 38
Soren has 	 fav team: Red Sox 	 RedSox friends: 55 	 Cardinals friends: 30
Spencer has 	 fav team: Red Sox 	 RedSox friends: 47 	 Cardinals friends: 29
Stanley has 	 fav team: Red Sox 	 RedSox friends: 51 	 Cardinals friends: 29
Stefan has 	 fav team: Cardinals 	 RedSox friends: 22 	 Cardinals friends: 46
Stella has 	 fav team: Cardinals 	 RedSox friends: 41 	 Cardinals friends: 55
Stephanie has 	 fav team: Cardinals 	 RedSox friends: 32 	 Cardinals friends: 54
Stephen has 	 fav team: Red Sox 	 RedSox friends: 52 	 Cardinals friends: 29
Sterling has 	 fav team: Red Sox 	 RedSox friends: 55 	 Cardinals friends: 31
Steve has 	 fav team: Cardinals 	 RedSox friends: 35 	 Cardinals friends: 45
Steven has 	 fav team: Cardinals 	 RedSox friends: 23 	 Cardinals friends: 55
Sullivan has 	 fav team: Cardinals 	 RedSox friends: 25 	 Cardinals friends: 59
Summer has 	 fav team: Cardinals 	 RedSox friends: 30 	 Cardinals friends: 54
Susan has 	 fav team: Cardinals 	 RedSox friends: 29 	 Cardinals friends: 49
Sydney has 	 fav team: Red Sox 	 RedSox friends: 43 	 Cardinals friends: 38
Sylas has 	 fav team: Cardinals 	 RedSox friends: 30 	 Cardinals friends: 50
Sylvia has 	 fav team: Red Sox 	 RedSox friends: 56 	 Cardinals friends: 27
Tabitha has 	 fav team: Red Sox 	 RedSox friends: 40 	 Cardinals friends: 26
Talia has 	 fav team: Cardinals 	 RedSox friends: 35 	 Cardinals friends: 53
Taliyah has 	 fav team: Red Sox 	 RedSox friends: 54 	 Cardinals friends: 31
Talon has 	 fav team: Red Sox 	 RedSox friends: 48 	 Cardinals friends: 39
Tamia has 	 fav team: Cardinals 	 RedSox friends: 33 	 Cardinals friends: 55
Tanner has 	 fav team: Cardinals 	 RedSox friends: 28 	 Cardinals friends: 48
Tara has 	 fav team: Cardinals 	 RedSox friends: 34 	 Cardinals friends: 53
Taraji has 	 fav team: Red Sox 	 RedSox friends: 50 	 Cardinals friends: 29
Taryn has 	 fav team: Red Sox 	 RedSox friends: 46 	 Cardinals friends: 35
Tate has 	 fav team: Red Sox 	 RedSox friends: 48 	 Cardinals friends: 21
Tatiana has 	 fav team: Red Sox 	 RedSox friends: 47 	 Cardinals friends: 30
Tatum has 	 fav team: Cardinals 	 RedSox friends: 29 	 Cardinals friends: 46
Taylor has 	 fav team: Red Sox 	 RedSox friends: 48 	 Cardinals friends: 20
Teagan has 	 fav team: Red Sox 	 RedSox friends: 41 	 Cardinals friends: 33
Temperance has 	 fav team: Cardinals 	 RedSox friends: 36 	 Cardinals friends: 39
Tenley has 	 fav team: Cardinals 	 RedSox friends: 41 	 Cardinals friends: 49
Teresa has 	 fav team: Red Sox 	 RedSox friends: 46 	 Cardinals friends: 30
Terrance has 	 fav team: Cardinals 	 RedSox friends: 28 	 Cardinals friends: 53
Terrell has 	 fav team: Cardinals 	 RedSox friends: 30 	 Cardinals friends: 60
Terrence has 	 fav team: Cardinals 	 RedSox friends: 34 	 Cardinals friends: 55
Terry has 	 fav team: Red Sox 	 RedSox friends: 46 	 Cardinals friends: 29
Tess has 	 fav team: Cardinals 	 RedSox friends: 30 	 Cardinals friends: 48
Tessa has 	 fav team: Cardinals 	 RedSox friends: 27 	 Cardinals friends: 44
Thaddeus has 	 fav team: Red Sox 	 RedSox friends: 39 	 Cardinals friends: 23
Thalia has 	 fav team: Red Sox 	 RedSox friends: 47 	 Cardinals friends: 36
Theo has 	 fav team: Cardinals 	 RedSox friends: 28 	 Cardinals friends: 48
Theodore has 	 fav team: Cardinals 	 RedSox friends: 23 	 Cardinals friends: 45
Thiago has 	 fav team: Cardinals 	 RedSox friends: 28 	 Cardinals friends: 58
Thomas has 	 fav team: Red Sox 	 RedSox friends: 47 	 Cardinals friends: 25
Tia has 	 fav team: Cardinals 	 RedSox friends: 37 	 Cardinals friends: 56
Tiana has 	 fav team: Red Sox 	 RedSox friends: 35 	 Cardinals friends: 34
Tiffany has 	 fav team: Red Sox 	 RedSox friends: 61 	 Cardinals friends: 29
Timothy has 	 fav team: Cardinals 	 RedSox friends: 20 	 Cardinals friends: 48
Tinley has 	 fav team: Red Sox 	 RedSox friends: 49 	 Cardinals friends: 35
Titan has 	 fav team: Red Sox 	 RedSox friends: 63 	 Cardinals friends: 34
Titus has 	 fav team: Red Sox 	 RedSox friends: 59 	 Cardinals friends: 33
Tobias has 	 fav team: Cardinals 	 RedSox friends: 28 	 Cardinals friends: 48
Toby has 	 fav team: Cardinals 	 RedSox friends: 22 	 Cardinals friends: 48
Todd has 	 fav team: Red Sox 	 RedSox friends: 44 	 Cardinals friends: 21
Tomas has 	 fav team: Cardinals 	 RedSox friends: 29 	 Cardinals friends: 45
Tommy has 	 fav team: Red Sox 	 RedSox friends: 55 	 Cardinals friends: 31
Tony has 	 fav team: Red Sox 	 RedSox friends: 53 	 Cardinals friends: 28
Tori has 	 fav team: Red Sox 	 RedSox friends: 56 	 Cardinals friends: 31
Trace has 	 fav team: Red Sox 	 RedSox friends: 51 	 Cardinals friends: 31
Travis has 	 fav team: Cardinals 	 RedSox friends: 29 	 Cardinals friends: 41
Trent has 	 fav team: Red Sox 	 RedSox friends: 45 	 Cardinals friends: 31
Trenton has 	 fav team: Cardinals 	 RedSox friends: 29 	 Cardinals friends: 50
Trevon has 	 fav team: Cardinals 	 RedSox friends: 26 	 Cardinals friends: 51
Trevor has 	 fav team: Cardinals 	 RedSox friends: 26 	 Cardinals friends: 47
Trey has 	 fav team: Cardinals 	 RedSox friends: 27 	 Cardinals friends: 49
Trinity has 	 fav team: Red Sox 	 RedSox friends: 64 	 Cardinals friends: 37
Tripp has 	 fav team: Red Sox 	 RedSox friends: 60 	 Cardinals friends: 28
Tristan has 	 fav team: Cardinals 	 RedSox friends: 19 	 Cardinals friends: 32
Tristen has 	 fav team: Cardinals 	 RedSox friends: 32 	 Cardinals friends: 43
Tristian has 	 fav team: Cardinals 	 RedSox friends: 30 	 Cardinals friends: 36
Tristin has 	 fav team: Red Sox 	 RedSox friends: 51 	 Cardinals friends: 27
Triston has 	 fav team: Cardinals 	 RedSox friends: 30 	 Cardinals friends: 58
Troy has 	 fav team: Cardinals 	 RedSox friends: 34 	 Cardinals friends: 45
Truman has 	 fav team: Cardinals 	 RedSox friends: 21 	 Cardinals friends: 44
Trystan has 	 fav team: Cardinals 	 RedSox friends: 22 	 Cardinals friends: 36
Tucker has 	 fav team: Red Sox 	 RedSox friends: 41 	 Cardinals friends: 18
Turner has 	 fav team: Red Sox 	 RedSox friends: 52 	 Cardinals friends: 26
Ty has 	 fav team: Cardinals 	 RedSox friends: 29 	 Cardinals friends: 48
Tyler has 	 fav team: Cardinals 	 RedSox friends: 24 	 Cardinals friends: 43
Tyree has 	 fav team: Red Sox 	 RedSox friends: 48 	 Cardinals friends: 30
Tyrell has 	 fav team: Cardinals 	 RedSox friends: 29 	 Cardinals friends: 48
Tyrone has 	 fav team: Cardinals 	 RedSox friends: 33 	 Cardinals friends: 50
Tyson has 	 fav team: Red Sox 	 RedSox friends: 45 	 Cardinals friends: 29
Ulises has 	 fav team: Red Sox 	 RedSox friends: 49 	 Cardinals friends: 27
Uriah has 	 fav team: Cardinals 	 RedSox friends: 26 	 Cardinals friends: 51
Uriel has 	 fav team: Cardinals 	 RedSox friends: 24 	 Cardinals friends: 53
Urijah has 	 fav team: Cardinals 	 RedSox friends: 41 	 Cardinals friends: 61
Valentin has 	 fav team: Cardinals 	 RedSox friends: 29 	 Cardinals friends: 50
Valentina has 	 fav team: Cardinals 	 RedSox friends: 20 	 Cardinals friends: 47
Valentino has 	 fav team: Cardinals 	 RedSox friends: 30 	 Cardinals friends: 51
Valeria has 	 fav team: Red Sox 	 RedSox friends: 48 	 Cardinals friends: 21
Valerie has 	 fav team: Cardinals 	 RedSox friends: 33 	 Cardinals friends: 55
Van has 	 fav team: Red Sox 	 RedSox friends: 46 	 Cardinals friends: 31
Vance has 	 fav team: Cardinals 	 RedSox friends: 25 	 Cardinals friends: 53
Vanessa has 	 fav team: Cardinals 	 RedSox friends: 39 	 Cardinals friends: 45
Vaughn has 	 fav team: Cardinals 	 RedSox friends: 31 	 Cardinals friends: 54
Vera has 	 fav team: Red Sox 	 RedSox friends: 45 	 Cardinals friends: 22
Veronica has 	 fav team: Red Sox 	 RedSox friends: 50 	 Cardinals friends: 34
Vicente has 	 fav team: Cardinals 	 RedSox friends: 25 	 Cardinals friends: 49
Victor has 	 fav team: Cardinals 	 RedSox friends: 28 	 Cardinals friends: 46
Victoria has 	 fav team: Red Sox 	 RedSox friends: 58 	 Cardinals friends: 26
Vihaan has 	 fav team: Cardinals 	 RedSox friends: 38 	 Cardinals friends: 48
Vincent has 	 fav team: Cardinals 	 RedSox friends: 29 	 Cardinals friends: 62
Vincenzo has 	 fav team: Red Sox 	 RedSox friends: 48 	 Cardinals friends: 34
Violet has 	 fav team: Red Sox 	 RedSox friends: 52 	 Cardinals friends: 28
Virginia has 	 fav team: Cardinals 	 RedSox friends: 21 	 Cardinals friends: 39
Vivian has 	 fav team: Red Sox 	 RedSox friends: 49 	 Cardinals friends: 36
Viviana has 	 fav team: Red Sox 	 RedSox friends: 56 	 Cardinals friends: 29
Vivienne has 	 fav team: Cardinals 	 RedSox friends: 45 	 Cardinals friends: 53
Wade has 	 fav team: Cardinals 	 RedSox friends: 23 	 Cardinals friends: 50
Walker has 	 fav team: Cardinals 	 RedSox friends: 31 	 Cardinals friends: 37
Walter has 	 fav team: Cardinals 	 RedSox friends: 41 	 Cardinals friends: 45
Warren has 	 fav team: Cardinals 	 RedSox friends: 20 	 Cardinals friends: 39
Waylon has 	 fav team: Cardinals 	 RedSox friends: 40 	 Cardinals friends: 52
Wayne has 	 fav team: Cardinals 	 RedSox friends: 35 	 Cardinals friends: 64
Wendy has 	 fav team: Red Sox 	 RedSox friends: 39 	 Cardinals friends: 30
Wesley has 	 fav team: Cardinals 	 RedSox friends: 27 	 Cardinals friends: 36
Westin has 	 fav team: Red Sox 	 RedSox friends: 41 	 Cardinals friends: 21
Weston has 	 fav team: Cardinals 	 RedSox friends: 25 	 Cardinals friends: 53
Whitney has 	 fav team: Cardinals 	 RedSox friends: 26 	 Cardinals friends: 47
Will has 	 fav team: Cardinals 	 RedSox friends: 27 	 Cardinals friends: 38
Willa has 	 fav team: Cardinals 	 RedSox friends: 27 	 Cardinals friends: 44
William has 	 fav team: Red Sox 	 RedSox friends: 58 	 Cardinals friends: 34
Willie has 	 fav team: Cardinals 	 RedSox friends: 31 	 Cardinals friends: 47
Willow has 	 fav team: Cardinals 	 RedSox friends: 24 	 Cardinals friends: 48
Wilson has 	 fav team: Cardinals 	 RedSox friends: 31 	 Cardinals friends: 37
Winston has 	 fav team: Red Sox 	 RedSox friends: 46 	 Cardinals friends: 34
Winter has 	 fav team: Cardinals 	 RedSox friends: 37 	 Cardinals friends: 49
Wyatt has 	 fav team: Cardinals 	 RedSox friends: 31 	 Cardinals friends: 63
Xander has 	 fav team: Cardinals 	 RedSox friends: 22 	 Cardinals friends: 43
Xavi has 	 fav team: Cardinals 	 RedSox friends: 28 	 Cardinals friends: 50
Xavier has 	 fav team: Cardinals 	 RedSox friends: 27 	 Cardinals friends: 42
Ximena has 	 fav team: Red Sox 	 RedSox friends: 43 	 Cardinals friends: 35
Xzavier has 	 fav team: Cardinals 	 RedSox friends: 34 	 Cardinals friends: 47
Yael has 	 fav team: Red Sox 	 RedSox friends: 42 	 Cardinals friends: 23
Yahir has 	 fav team: Cardinals 	 RedSox friends: 26 	 Cardinals friends: 39
Yamileth has 	 fav team: Red Sox 	 RedSox friends: 57 	 Cardinals friends: 28
Yandel has 	 fav team: Cardinals 	 RedSox friends: 36 	 Cardinals friends: 44
Yareli has 	 fav team: Cardinals 	 RedSox friends: 28 	 Cardinals friends: 55
Yaretzi has 	 fav team: Red Sox 	 RedSox friends: 54 	 Cardinals friends: 28
Yaritza has 	 fav team: Red Sox 	 RedSox friends: 57 	 Cardinals friends: 43
Yasmin has 	 fav team: Cardinals 	 RedSox friends: 28 	 Cardinals friends: 42
Yehuda has 	 fav team: Red Sox 	 RedSox friends: 50 	 Cardinals friends: 20
Yesenia has 	 fav team: Red Sox 	 RedSox friends: 48 	 Cardinals friends: 23
Yosef has 	 fav team: Cardinals 	 RedSox friends: 32 	 Cardinals friends: 34
Yousef has 	 fav team: Red Sox 	 RedSox friends: 48 	 Cardinals friends: 30
Yusuf has 	 fav team: Red Sox 	 RedSox friends: 54 	 Cardinals friends: 24
Zachariah has 	 fav team: Cardinals 	 RedSox friends: 28 	 Cardinals friends: 48
Zachary has 	 fav team: Cardinals 	 RedSox friends: 36 	 Cardinals friends: 54
Zackary has 	 fav team: Red Sox 	 RedSox friends: 45 	 Cardinals friends: 23
Zahra has 	 fav team: Red Sox 	 RedSox friends: 60 	 Cardinals friends: 41
Zaid has 	 fav team: Cardinals 	 RedSox friends: 26 	 Cardinals friends: 49
Zaiden has 	 fav team: Cardinals 	 RedSox friends: 32 	 Cardinals friends: 40
Zain has 	 fav team: Cardinals 	 RedSox friends: 28 	 Cardinals friends: 54
Zaire has 	 fav team: Red Sox 	 RedSox friends: 44 	 Cardinals friends: 31
Zander has 	 fav team: Red Sox 	 RedSox friends: 49 	 Cardinals friends: 26
Zane has 	 fav team: Cardinals 	 RedSox friends: 25 	 Cardinals friends: 52
Zaniyah has 	 fav team: Cardinals 	 RedSox friends: 28 	 Cardinals friends: 40
Zara has 	 fav team: Cardinals 	 RedSox friends: 33 	 Cardinals friends: 47
Zaria has 	 fav team: Cardinals 	 RedSox friends: 32 	 Cardinals friends: 47
Zariah has 	 fav team: Cardinals 	 RedSox friends: 35 	 Cardinals friends: 50
Zariyah has 	 fav team: Red Sox 	 RedSox friends: 44 	 Cardinals friends: 36
Zavier has 	 fav team: Red Sox 	 RedSox friends: 52 	 Cardinals friends: 33
Zayden has 	 fav team: Red Sox 	 RedSox friends: 50 	 Cardinals friends: 25
Zayne has 	 fav team: Cardinals 	 RedSox friends: 41 	 Cardinals friends: 63
Zechariah has 	 fav team: Red Sox 	 RedSox friends: 53 	 Cardinals friends: 25
Zeke has 	 fav team: Cardinals 	 RedSox friends: 34 	 Cardinals friends: 50
Zion has 	 fav team: Cardinals 	 RedSox friends: 26 	 Cardinals friends: 40
Zoe has 	 fav team: Red Sox 	 RedSox friends: 45 	 Cardinals friends: 30
Zoey has 	 fav team: Red Sox 	 RedSox friends: 44 	 Cardinals friends: 38
Zoie has 	 fav team: Red Sox 	 RedSox friends: 46 	 Cardinals friends: 31
Zuri has 	 fav team: Cardinals 	 RedSox friends 24 	 Cardinals friends 64
